#
# Wordless: Mapping Table (UniDic Tagset -> Universal Part-of-speech Tagset)
#
# Copyright (C) 2018 Ye Lei (叶磊) <blkserene@gmail.com>
#
# License Information: https://github.com/BLKSerene/Wordless/blob/master/LICENSE.txt
#

#
# UniDic Tagset: https://gist.github.com/masayu-a/e3eee0637c07d4019ec9
#
# Universal Part-of-speech Tagset: https://github.com/slavpetrov/universal-pos-tags/blob/master/README
#

代名詞	PRON	# Pronoun
副詞	ADV	# Adverb
助動詞	PART	# Auxiliary verb
助詞	PART	# Particle
動詞	VERB	# Verb
名詞	NOUN	# Noun
形容詞	ADJ	# Adjective
形状詞	NOUN	# Adjectival noun
感動詞	INTJ	# Interjection
接尾辞	PART	# Suffix
接続詞	CCONJ/SCONJ	# Conjunction
接頭辞	PART	# Prefix
空白	X	# Whitespace
補助記号	PUNCT/SYM	# Supplementary symbol
記号	SYM	# Symbol
連体詞	PART	# Adnominal
未知語	X	# Unknown words
oov	X	# Unknown words
漢文	X	# Chinese writing
英単語	X	# English Word
言いよどみ	X	# Hesitation
web誤脱	X	# Errors and omissions
ローマ字文	X	# Latin alphabet
URL	SYM	# URL
