­Ъўђ	рІерѕџрѕхрЅЁ рЇірЅх
­ЪўЂ	рІерѕџрІФрЅЦрѕерЅђрѕГрЅЁ рЇірЅх рЅарЇѕрїѕрїЇрЅ│ ріарІГріќрЅй
­Ъўѓ	рЇірЅх рЅарІ░рѕхрЅ│ ріЦріЋрЅБ
­ЪцБ	рѕўрѕгрЅх рѕІрІГ ріЦрІерЅ░ріЋріерЅБрѕѕрѕѕ ріЦрІерѕ│рЅђ
­ЪўЃ	рЅарЅхрѕЇрѕЇрЅЁ ріарІГріќрЅй рІерѕџрѕхрЅЁ рЇірЅх
­Ъўё	рЇѕрїѕрїЇ рІФрѕѕ рЇірЅх рЅарЇѕрїѕрїЇрЅ│ ріарІГріќрЅй
­ЪўЁ	рЅарѕІрЅЦ рІерѕџрѕхрЅЁ рЇірЅх
­Ъўє	рЇѕрїѕрїЇ рІФрѕѕ рІЊрІГріЊрЇІрѕГ рЇірЅх
­ЪўЅ	рїарѕўрІЮрѕЏрІЏ рЇірЅх
­Ъўі	рЇѕрїѕрїЇ рІФрѕѕ рЇірЅх рЅарЇѕрїѕрїЇрЅ│ ріарІГріќрЅй
­ЪўІ	рЇірЅх рІерѕџрїБрЇЇрїЦ рѕЮрїЇрЅЦ
­Ъўј	рІерЇђрѕљрІГ рѕўріљрЇЁрѕГ рІФрѕѕрІЇ рЇѕрїѕрїЇрЅ│ рЇірЅх
­ЪўЇ	рЇѕрїѕрїЇрЅ│ рЇірЅх ріерѕЇрЅЦ ріарІГріќрЅй рїІрѕГ
­Ъўў	рЇірЅх рѕўрѕ│рѕЮ ріЦрІеріљрЇІ
­ЪЦ░	3 рѕЇрЅдрЅй рІФрѕЅрЅх рЇѕрїѕрїЇрЅ│ рЇірЅх
­ЪўЌ	рІерѕўрѕ│рѕЮ рЇірЅх
­ЪўЎ	рЅарЇѕрїѕрїЇрЅ│ ріарІГріќрЅй рІерѕўрѕ│рѕЮ рЇірЅх
­Ъўџ	рІерЅ░рІўрїЅ рІЊрІГріќрЅй рІФрѕЅрЅх рІерѕўрѕ│рѕЮ рЇірЅх
Рў║№ИЈ	рЇѕрїѕрїЇ рІФрѕѕ рЇірЅх
Рў║	рЇѕрїѕрїЇ рІФрѕѕ рЇірЅх
­ЪЎѓ	рЅхріЋрѕй рЇѕрїѕрїЇрЅ│ рІФрѕѕрІЇ рЇірЅх
­ЪцЌ	рѕЏрЅђрЇЇ рЇірЅх
­ЪцЕ	рЅарі«ріерЅЦ рЅ░рѕўрЅ│
­Ъцћ	рІерѕџрІФрѕхрЅЦ рЇірЅх
­Ъце	ріерЇЇ рІФрѕѕ рЅЁріЋрІхрЅЦ рІФрѕѕрІЇ рЇірЅх
­Ъўљ	рїѕрѕѕрѕЇрЅ░ріЏ рЇірЅх
­ЪўЉ	рѕўрїЇрѕѕрїФ рІерѕїрѕѕрІЇ рЇірЅх
­ЪўХ	ріарЇЇ рІерѕїрѕѕрЅарЅх рЇірЅх
­ЪЎё	рІерѕџрѕйріерѕеріерѕЕ рІЊрІГріќрЅй рІФрѕЅрЅх рЇірЅх
­ЪўЈ	рЇѕрїѕрїЇрЅ│ рІФрѕѕрІЇ рЇірЅх
­ЪўБ	рїйріЊрЅх рЇірЅх
­ЪўЦ	ріарѕ│рІЏріЮ рїЇріЋ ріЦрЇјрІГрЅ│ рІФрѕѕрІЇ рЇірЅх
­Ъў«	ріГрЇЇрЅх ріарЇЇ рІФрѕѕрІЇ рЇірЅх
­Ъцљ	рІџрЇљрѕГ-ріарЇЇ рЇірЅх
­Ъў»	рІерЅ░рІ░рЅєрѕ░ рЇірЅх
­Ъўф	рІерѕџрІФріЋрЅђрѕІрЇІ рЇірЅх
­ЪўФ	рІерІ░ріерѕў рЇірЅх
­Ъў┤	рІерѕџрЅ░ріЏ рЇірЅх
­Ъўї	ріЦрЇјрІГрЅ│ рІФрѕѕрІЇ рЇірЅх
­ЪўЏ	рЇірЅх рЅарѕЮрѕІрѕх
­Ъўю	рІерѕџрїБрЅђрѕх рЇірЅх рЅарѕЮрѕІрѕх
­ЪўЮ	рѕЮрѕІрѕ▒ріЋ рІерѕџрІФрі«рѕФ рЇірЅх
­Ъцц	рІерѕџріЋрїарЅБрїарЅЦ рЇірЅх
­Ъўњ	рІФрѕЇрЅ░рІЮріЊріЊ рЇірЅх
­ЪўЊ	рІерІѕрѕерІ░ рЇірЅх рЅарѕІрЅЦ
­Ъўћ	рІерѕџрІФрѕхрЇѕрѕФ рЇірЅх
­ЪўЋ	рїЇрѕФ рІерЅ░рїІрЅБ рЇірЅх
­ЪЎЃ	рІерЅ░рїѕрѕѕрЅарїа рЇірЅх
­ЪцЉ	рїѕріЋрІўрЅЦ-ріарЇЇ рЇірЅх
­Ъў▓	рІерЅ░рїѕрѕерѕў рЇірЅх
Рў╣№ИЈ	рІерЅ░рі«рѕ│рЅ░рѕе рЇірЅх
Рў╣	рІерЅ░рі«рѕ│рЅ░рѕе рЇірЅх
­ЪЎЂ	рЅарЅхріЋрѕ╣ рІерЅ░рі«рѕ│рЅ░рѕе рЇірЅх
­Ъўќ	рїЇрѕФ рІерЅ░рїІрЅБ рЇірЅх
­Ъўъ	рЅ░рѕхрЇІ рІерЅєрѕерїа рЇірЅх
­ЪўЪ	рІерЅ░рїеріљрЅђ рЇірЅх
­Ъўц	ріеріарЇЇріЋрїФ рЅаріЦріЋрЇІрѕјрЅх рЇірЅх
­Ъўб	рІерѕџрІФрѕѕрЅЁрѕх рЇірЅх
­ЪўГ	рї«ріГ рЅЦрѕј рІерѕџрІФрѕѕрЅЁрѕх рЇірЅх
­Ъўд	рІерЅ░рі«рѕ│рЅ░рѕе рЇірЅх ріерЅ░ріерЇѕрЅ░ ріарЇЇ
­ЪўД	рІерЅ░рїеріљрЅђ рЇірЅх
­Ъўе	ріарѕхрЇѕрѕф рЇірЅх
­ЪўЕ	рІерІ░ріерѕў рЇірЅх
­Ъц»	рІерѕџрЇѕріљрІ│ рїГріЋрЅЁрѕІрЅх
­Ъўг	рІерѕџрІФрѕИрѕЏрЅЁрЅЁ рЇірЅх
­Ъў░	рІерЅ░рїеріљрЅђ рЇірЅх рЅарѕІрЅЦ
­Ъў▒	рЅарЇЇрѕГрѕЃрЅх рІерѕџрї«рѕЁ рЇірЅх
­ЪЦх	рЅхріЕрѕх рЇірЅх
­ЪЦХ	рЅђрІЮрЅЃрІЏ рЇірЅх
­Ъў│	рІерЅ│рѕИрїѕ рЇірЅх
­Ъцф	zany рЇірЅх
­Ъўх	рѕўрЇЇрІўрІЮ рЇірЅх
­ЪўА	рЇірЅхріЋ рѕЏрЇЇрѕ░рѕх
­Ъўа	рІерЅ░ріЊрІ░рІ░ рЇірЅх
­Ъцг	рЅаріарЇЇ рѕІрІГ рѕЮрѕЇріГрЅХрЅй рІФрѕЅрЅх рЇірЅх
­Ъўи	рІерѕЋріГрѕЮріЊ рїГрѕЮрЅЦрѕЇ рІФрѕѕрІЇ рЇірЅх
­Ъцњ	рЅ┤рѕГрѕърѕюрЅхрѕГ рІФрѕѕрІЇ рЇірЅх
­ЪцЋ	рЇірЅх рѕѕрЇірЅх ріерѕФрѕх-рЇІрѕ╗ рїІрѕГ
­Ъцб	рІерѕЏрЅЁрѕѕрѕйрѕѕрѕй рЇірЅх
­Ъц«	рЇірЅх рѕЏрѕхрЅ│рІѕріГ
­ЪцД	рІерѕџрІФрѕхріљрїЦрѕх рЇірЅх
­ЪўЄ	рѕЃрѕј рІФрѕѕрІЇ рЇѕрїѕрїЇрЅ│ рЇірЅх
­Ъца	ріФрІЇрЅдрІГ рЅБрѕГріћрїБ рЇірЅх
­ЪЦ│	рІерЇЊрѕГрЅ▓ рЇірЅх
­ЪЦ┤	рІерѕџрІФрѕИрѕЏрЅЁрЅЁ рЇірЅх
­ЪЦ║	рІерѕџрІФрѕЏрѕЇрІх рЇірЅх
­ЪцЦ	рІерІЇрѕИрЅх рЇірЅх
­ЪцФ	рІерѕџрѕИрѕЏрЅђрЅЁ рЇірЅх
­ЪцГ	рЇірЅх рЅаріарЇЇ рѕІрІГ рЅаріЦрїЁ
­ЪДљ	ріе monocle рїІрѕГ рЇірЅх
­ЪцЊ	ріљрѕГрІх рЇірЅх
­Ъўѕ	рЅђріЋрІХрЅй рІФрѕЅрЅх рЇѕрїѕрїЇрЅ│ рЇірЅх
­ЪЉ┐	рІерЅ░ріЊрІ░рІ░ рЇірЅх рЅарЅђріЋрІХрЅй
­ЪцА	рЅђрѕЇрІ░ріЏ рЇірЅх
­ЪЉ╣	рідрїЇрѕг
­ЪЉ║	рїјрЅЦрѕіріЋ
­Ъњђ	рІерѕФрѕх рЅЁрѕЇ
Рўа№ИЈ	рІерѕФрѕх рЅЁрѕЇ ріЦріЊ ріарїЦріЋрЅх
Рўа	рІерѕФрѕх рЅЁрѕЇ ріЦріЊ ріарїЦріЋрЅх
­ЪЉ╗	рѕўріЋрЇѕрѕх
­ЪЉй	рЅБрІЋрІх
­ЪЉЙ	рЅБрІЋрІх рїГрѕФрЅЁ
­Ъцќ	рІерѕ«рЅдрЅх рЇірЅх
­ЪњЕ	рІерІхрѕєрЅй ріГрѕЮрѕГ
­Ъў║	рІерѕџрѕхрЅЁ рІхрѕўрЅх рЇірЅх
­ЪўИ	рЇѕрїѕрїЇ рІФрѕѕ рІерІхрѕўрЅх рЇірЅх рЅарЇѕрїѕрїЇрЅ│ ріарІГріќрЅй
­Ъў╣	рІерІхрѕўрЅх рЇірЅх рЅарІ░рѕхрЅ│ ріЦріЋрЅБ
­Ъў╗	рЇѕрїѕрїЇрЅ│ рІерІхрѕўрЅх рЇірЅх рЅарѕЇрЅЦ ріарІГріќрЅй
­Ъў╝	рІерІхрѕўрЅх рЇірЅх рЅарЅЦрѕхрїГрЅх рЇѕрїѕрїЇрЅ│
­Ъўй	рІерѕўрѕ│рѕЮ рІхрѕўрЅх рЇірЅх
­ЪЎђ	рІерІ░ріерѕў рІхрѕўрЅх рЇірЅх
­Ъў┐	рІерѕџрІФрѕѕрЅЁрѕх рІхрѕўрЅх рЇірЅх
­ЪўЙ	рІерІхрѕўрЅх рЇірЅх ріЦрІФрЇѕрѕ░рѕ▒
­ЪЎѕ	ріЦрІГ-рѕЮріЋрѕЮ-ріГрЇЅ рїдрїБ
­ЪЎЅ	рѕхрѕЏ-ріарІГ-ріГрЇЅ рїдрїБ
­ЪЎі	рЅ░ріЊрїѕрѕГ-рѕЮріЋрѕЮ-ріГрЇЅ рїдрїБ
­ЪЈ╗	рЅђрѕІрѕЇ рІерЅєрІ│ рЅђрѕѕрѕЮ
­ЪЈ╝	рѕўріФріерѕѕріЏ-рЅђрѕІрѕЇ рІерЅєрІ│ рЅђрѕѕрѕЮ
­ЪЈй	рѕўріФріерѕѕріЏ рІерЅєрІ│ рЅђрѕѕрѕЮ
­ЪЈЙ	рѕўріФріерѕѕріЏ-рїЦрЅЂрѕГ рІерЅєрІ│ рЅђрѕѕрѕЮ
­ЪЈ┐	рїЦрЅЂрѕГ рІерЅєрІ│ рЅђрѕѕрѕЮ
­ЪЉХ	рѕЋрЇЃріЋ
­ЪЉХ­ЪЈ╗	рѕЋрЇЃріЋ: рЅђрѕІрѕЇ рІерЅєрІ│ рЅђрѕѕрѕЮ
­ЪЉХ­ЪЈ╝	рѕЋрЇЃріЋ: рѕўрѕЃріерѕѕріЏ рЅђрѕІ рІФрѕѕ рІерЅєрІ│ рЅђрѕѕрѕЮ
­ЪЉХ­ЪЈй	рѕЋрЇЃріЋ: рѕўрѕЃріерѕѕріЏ рІерЅєрІ│ рЅђрѕѕрѕЮ
­ЪЉХ­ЪЈЙ	рѕЋрЇЃріЋ: рѕўрѕЃріерѕѕріЏ-рїЦрЅЂрѕГ рІерЅєрІ│ рЅђрѕѕрѕЮ
­ЪЉХ­ЪЈ┐	рѕЋрЇЃріЋ: рїЦрЅЂрѕГ рІерЅєрІ│ рЅђрѕѕрѕЮ
­ЪДњ	рѕЇрїЁ
­ЪДњ­ЪЈ╗	рѕЇрїЁ: рЅђрѕІрѕЇ рІерЅєрІ│ рЅђрѕѕрѕЮ
­ЪДњ­ЪЈ╝	рѕЇрїЁ: рѕўрѕЃріерѕѕріЏ рЅђрѕІ рІФрѕѕ рІерЅєрІ│ рЅђрѕѕрѕЮ
­ЪДњ­ЪЈй	рѕЇрїЁ: рѕўрѕЃріерѕѕріЏ рІерЅєрІ│ рЅђрѕѕрѕЮ
­ЪДњ­ЪЈЙ	рѕЇрїЁ: рѕўрѕЃріерѕѕріЏ-рїЦрЅЂрѕГ рІерЅєрІ│ рЅђрѕѕрѕЮ
­ЪДњ­ЪЈ┐	рѕЇрїЁ: рїЦрЅЂрѕГ рІерЅєрІ│ рЅђрѕѕрѕЮ
­ЪЉд	рІѕріЋрІх рѕЇрїЁ
­ЪЉд­ЪЈ╗	рІѕріЋрІх рѕЇрїЁ: рЅђрѕІрѕЇ рІерЅєрІ│ рЅђрѕѕрѕЮ
­ЪЉд­ЪЈ╝	рІѕріЋрІх рѕЇрїЁ: рѕўрѕЃріерѕѕріЏ рЅђрѕІ рІФрѕѕ рІерЅєрІ│ рЅђрѕѕрѕЮ
­ЪЉд­ЪЈй	рІѕріЋрІх рѕЇрїЁ: рѕўрѕЃріерѕѕріЏ рІерЅєрІ│ рЅђрѕѕрѕЮ
­ЪЉд­ЪЈЙ	рІѕріЋрІх рѕЇрїЁ: рѕўрѕЃріерѕѕріЏ рЅђрѕІ рІФрѕѕ рІерЅєрІ│ рЅђрѕѕрѕЮ
­ЪЉд­ЪЈ┐	рѕЇрїЁ: рїЦрЅЂрѕГ рІерЅєрІ│ рЅђрѕѕрѕЮ
­ЪЉД	рѕ┤рЅх рѕЇрїЁ
­ЪЉД­ЪЈ╗	рѕЇрїЃрїѕрѕерІх: рЅђрѕІрѕЇ рІерЅєрІ│ рЅђрѕѕрѕЮ
­ЪЉД­ЪЈ╝	рѕЇрїЃрїѕрѕерІх: рѕўрѕЃріерѕѕріЏ рЅђрѕІ рІФрѕѕ рІерЅєрІ│ рЅђрѕѕрѕЮ
­ЪЉД­ЪЈй	рѕЇрїЃрїѕрѕерІх: рѕўрѕЃріерѕѕріЏ рІерЅєрІ│ рЅђрѕѕрѕЮ
­ЪЉД­ЪЈЙ	рѕЇрїЃрїѕрѕерІх: рѕўрѕЃріерѕѕріЏ-рїЦрЅЂрѕГ рІерЅєрІ│ рЅђрѕѕрѕЮ
­ЪЉД­ЪЈ┐	рѕЇрїЃрїѕрѕерІх: рїЦрЅЂрѕГ рІерЅєрІ│ рЅђрѕѕрѕЮ
­ЪДЉ	ріарІІрЅѓ
­ЪДЉ­ЪЈ╗	ріарІІрЅѓрЇА рЅђрѕІрѕЇ рІерЅєрІ│ рЅђрѕѕрѕЮ
­ЪДЉ­ЪЈ╝	ріарІІрЅѓрЇА рѕўрѕЃріерѕѕріЏ рЅђрѕІ рІФрѕѕ рІерЅєрІ│ рЅђрѕѕрѕЮ
­ЪДЉ­ЪЈй	ріарІІрЅѓ: рѕўрѕЃріерѕѕріЏ рІерЅєрІ│ рЅђрѕѕрѕЮ
­ЪДЉ­ЪЈЙ	ріарІІрЅѓ: рѕўрѕЃріерѕѕріЏ-рїЦрЅЂрѕГ рІерЅєрІ│ рЅђрѕѕрѕЮ
­ЪДЉ­ЪЈ┐	ріарІІрЅѓ: рїЦрЅЂрѕГ рІерЅєрІ│ рЅђрѕѕрѕЮ
­ЪЉе	рѕ░рІЇ
­ЪЉе­ЪЈ╗	рѕ░рІЇрЇА рЅђрѕІрѕЇ рІерЅєрІ│ рЅђрѕѕрѕЮ
­ЪЉе­ЪЈ╝	рѕ░рІЇ: рѕўрѕЃріерѕѕріЏ рЅђрѕІ рІФрѕѕ рІерЅєрІ│ рЅђрѕѕрѕЮ
­ЪЉе­ЪЈй	рѕ░рІЇ: рѕўрѕЃріерѕѕріЏ рІерЅєрІ│ рЅђрѕѕрѕЮ
­ЪЉе­ЪЈЙ	рѕ░рІЇ: рѕўрѕЃріерѕѕріЏ-рїЦрЅЂрѕГ рІерЅєрІ│ рЅђрѕѕрѕЮ
­ЪЉе­ЪЈ┐	рѕ░рІЇ: рїЦрЅЂрѕГ рІерЅєрІ│ рЅђрѕѕрѕЮ
­ЪЉЕ	рѕ┤рЅх
­ЪЉЕ­ЪЈ╗	рѕ┤рЅх: рЅђрѕІрѕЇ рІерЅєрІ│ рЅђрѕѕрѕЮ
­ЪЉЕ­ЪЈ╝	рѕ┤рЅх: рѕўрѕЃріерѕѕріЏ рЅђрѕІ рІФрѕѕ рІерЅєрІ│ рЅђрѕѕрѕЮ
­ЪЉЕ­ЪЈй	рѕ┤рЅх: рѕўрѕЃріерѕѕріЏ рІерЅєрІ│ рЅђрѕѕрѕЮ
­ЪЉЕ­ЪЈЙ	рѕ┤рЅх: рѕўрѕЃріерѕѕріЏ-рїЦрЅЂрѕГ рІерЅєрІ│ рЅђрѕѕрѕЮ
­ЪЉЕ­ЪЈ┐	рѕ┤рЅх: рїЦрЅЂрѕГ рІерЅєрІ│ рЅђрѕѕрѕЮ
­ЪДЊ	ріарѕерїІрІі ріарІІрЅѓ
­ЪДЊ­ЪЈ╗	рЅхрѕЇрЅЁ рѕ░рІЇрЇА рЅђрѕІрѕЇ рІерЅєрІ│ рЅђрѕѕрѕЮ
­ЪДЊ­ЪЈ╝	рЅхрѕЇрЅЁ рѕ░рІЇрЇА рѕўрѕЃріерѕѕріЏ рЅђрѕІ рІФрѕѕ рІерЅєрІ│ рЅђрѕѕрѕЮ
­ЪДЊ­ЪЈй	рЅхрѕЇрЅЁ рѕ░рІЇрЇА рѕўрѕЃріерѕѕріЏ рІерЅєрІ│ рЅђрѕѕрѕЮ
­ЪДЊ­ЪЈЙ	ріарІЏрІЇріЋрЅх: рѕўрѕЃріерѕѕріЏ-рїЦрЅЂрѕГ рІерЅєрІ│ рЅђрѕѕрѕЮ
­ЪДЊ­ЪЈ┐	ріарѕерїІрІі: рїЦрЅЂрѕГ рІерЅєрІ│ рЅђрѕѕрѕЮ
­ЪЉ┤	рѕйрѕЏрїЇрѕї
­ЪЉ┤­ЪЈ╗	рѕйрѕЏрїЇрѕїрЇА рЅђрѕІрѕЇ рІерЅєрІ│ рЅђрѕѕрѕЮ
­ЪЉ┤­ЪЈ╝	рѕйрѕЏрїЇрѕїрЇА рѕўрѕЃріерѕѕріЏ рЅђрѕІ рІФрѕѕ рІерЅєрІ│ рЅђрѕѕрѕЮ
­ЪЉ┤­ЪЈй	ріарІЏрІЇріЋрЅх: рѕўрѕЃріерѕѕріЏ рІерЅєрІ│ рЅђрѕѕрѕЮ
­ЪЉ┤­ЪЈЙ	рѕйрѕЏрїЇрѕїрЇА рѕўрѕЃріерѕѕріЏ рЅђрѕІ рІФрѕѕ рІерЅєрІ│ рЅђрѕѕрѕЮ
­ЪЉ┤­ЪЈ┐	рѕйрѕЏрїЇрѕї: рїЦрЅЂрѕГ рІерЅєрІ│ рЅђрѕѕрѕЮ
­ЪЉх	ріарѕ«рїірЅх
­ЪЉх­ЪЈ╗	ріарѕ«рїірЅх рѕ┤рЅх: рЅђрѕІрѕЇ рІерЅєрІ│ рЅђрѕѕрѕЮ
­ЪЉх­ЪЈ╝	ріарѕ«рїірЅх рѕ┤рЅх: рѕўрѕЃріерѕѕріЏ рЅђрѕІ рІФрѕѕ рІерЅєрІ│ рЅђрѕѕрѕЮ
­ЪЉх­ЪЈй	ріарѕ«рїірЅх рѕ┤рЅх: рѕўрѕЃріерѕѕріЏ рІерЅєрІ│ рЅђрѕѕрѕЮ
­ЪЉх­ЪЈЙ	ріарѕ«рїірЅх рѕ┤рЅх: рѕўрѕЃріерѕѕріЏ-рїЦрЅЂрѕГ рІерЅєрІ│ рЅђрѕѕрѕЮ
­ЪЉх­ЪЈ┐	ріарѕ«рїірЅх рѕ┤рЅх: рїЦрЅЂрѕГ рІерЅєрІ│ рЅђрѕѕрѕЮ
­ЪЉеРђЇРџЋ№ИЈ	рѕ░рІЇ рІерїцріЊ рѕ░рѕФрЅ░ріЏ
­ЪЉеРђЇРџЋ	рѕ░рІЇ рІерїцріЊ рѕ░рѕФрЅ░ріЏ
­ЪЉе­ЪЈ╗РђЇРџЋ№ИЈ	рІѕріЋрІх рІерїцріЊ рЅБрѕѕрѕЎрІФрЇА рЅђрѕІрѕЇ рІерЅєрІ│ рЅђрѕѕрѕЮ
­ЪЉе­ЪЈ╗РђЇРџЋ	рІѕріЋрІх рІерїцріЊ рЅБрѕѕрѕЎрІФрЇА рЅђрѕІрѕЇ рІерЅєрІ│ рЅђрѕѕрѕЮ
­ЪЉе­ЪЈ╝РђЇРџЋ№ИЈ	рІѕріЋрІх рІерїцріЊ рѕ░рѕФрЅ░ріЏрЇА рѕўрѕЃріерѕѕріЏ рЅђрѕІ рІФрѕѕ рІерЅєрІ│ рЅђрѕѕрѕЮ
­ЪЉе­ЪЈ╝РђЇРџЋ	рІѕріЋрІх рІерїцріЊ рѕ░рѕФрЅ░ріЏрЇА рѕўрѕЃріерѕѕріЏ рЅђрѕІ рІФрѕѕ рІерЅєрІ│ рЅђрѕѕрѕЮ
­ЪЉе­ЪЈйРђЇРџЋ№ИЈ	рІѕріЋрІх рІерїцріЊ рЅБрѕѕрѕЎрІФрЇА рѕўрѕЃріерѕѕріЏ рІерЅєрІ│ рЅђрѕѕрѕЮ
­ЪЉе­ЪЈйРђЇРџЋ	рІѕріЋрІх рІерїцріЊ рЅБрѕѕрѕЎрІФрЇА рѕўрѕЃріерѕѕріЏ рІерЅєрІ│ рЅђрѕѕрѕЮ
­ЪЉе­ЪЈЙРђЇРџЋ№ИЈ	рІѕріЋрІх рІерїцріЊ рЅБрѕѕрѕЎрІФрЇА рѕўрѕЃріерѕѕріЏ рЅђрѕІ рІФрѕѕ рІерЅєрІ│ рЅђрѕѕрѕЮ
­ЪЉе­ЪЈЙРђЇРџЋ	рІѕріЋрІх рІерїцріЊ рЅБрѕѕрѕЎрІФрЇА рѕўрѕЃріерѕѕріЏ рЅђрѕІ рІФрѕѕ рІерЅєрІ│ рЅђрѕѕрѕЮ
­ЪЉе­ЪЈ┐РђЇРџЋ№ИЈ	рІѕріЋрІх рІерїцріЊ рЅБрѕѕрѕЎрІФ: рїЦрЅЂрѕГ рІерЅєрІ│ рЅђрѕѕрѕЮ
­ЪЉе­ЪЈ┐РђЇРџЋ	рІѕріЋрІх рІерїцріЊ рЅБрѕѕрѕЎрІФ: рїЦрЅЂрѕГ рІерЅєрІ│ рЅђрѕѕрѕЮ
­ЪЉЕРђЇРџЋ№ИЈ	рѕ┤рЅх рІерїцріЊ рѕ░рѕФрЅ░ріЏ
­ЪЉЕРђЇРџЋ	рѕ┤рЅх рІерїцріЊ рѕ░рѕФрЅ░ріЏ
­ЪЉЕ­ЪЈ╗РђЇРџЋ№ИЈ	рѕ┤рЅх рІерїцріЊ рѕ░рѕФрЅ░ріЏрЇА рЅђрѕІрѕЇ рІерЅєрІ│ рЅђрѕѕрѕЮ
­ЪЉЕ­ЪЈ╗РђЇРџЋ	рѕ┤рЅх рІерїцріЊ рѕ░рѕФрЅ░ріЏрЇА рЅђрѕІрѕЇ рІерЅєрІ│ рЅђрѕѕрѕЮ
­ЪЉЕ­ЪЈ╝РђЇРџЋ№ИЈ	рѕ┤рЅх рІерїцріЊ рѕ░рѕФрЅ░ріЏрЇА рѕўрѕЃріерѕѕріЏ рЅђрѕІ рІФрѕѕ рІерЅєрІ│ рЅђрѕѕрѕЮ
­ЪЉЕ­ЪЈ╝РђЇРџЋ	рѕ┤рЅх рІерїцріЊ рѕ░рѕФрЅ░ріЏрЇА рѕўрѕЃріерѕѕріЏ рЅђрѕІ рІФрѕѕ рІерЅєрІ│ рЅђрѕѕрѕЮ
­ЪЉЕ­ЪЈйРђЇРџЋ№ИЈ	рѕ┤рЅх рІерїцріЊ рѕ░рѕФрЅ░ріЏрЇА рѕўрѕЃріерѕѕріЏ рІерЅєрІ│ рЅђрѕѕрѕЮ
­ЪЉЕ­ЪЈйРђЇРџЋ	рѕ┤рЅх рІерїцріЊ рѕ░рѕФрЅ░ріЏрЇА рѕўрѕЃріерѕѕріЏ рІерЅєрІ│ рЅђрѕѕрѕЮ
­ЪЉЕ­ЪЈЙРђЇРџЋ№ИЈ	рѕ┤рЅх рІерїцріЊ рѕ░рѕФрЅ░ріЏрЇА рѕўрѕЃріерѕѕріЏ рЅђрѕІ рІФрѕѕ рІерЅєрІ│ рЅђрѕѕрѕЮ
­ЪЉЕ­ЪЈЙРђЇРџЋ	рѕ┤рЅх рІерїцріЊ рѕ░рѕФрЅ░ріЏрЇА рѕўрѕЃріерѕѕріЏ рЅђрѕІ рІФрѕѕ рІерЅєрІ│ рЅђрѕѕрѕЮ
­ЪЉЕ­ЪЈ┐РђЇРџЋ№ИЈ	рѕ┤рЅх рІерїцріЊ рѕ░рѕФрЅ░ріЏрЇА рїЦрЅЂрѕГ рІерЅєрІ│ рЅђрѕѕрѕЮ
­ЪЉЕ­ЪЈ┐РђЇРџЋ	рѕ┤рЅх рІерїцріЊ рѕ░рѕФрЅ░ріЏрЇА рїЦрЅЂрѕГ рІерЅєрІ│ рЅђрѕѕрѕЮ
­ЪЉеРђЇ­ЪјЊ	рІѕріЋрІх рЅ░рѕЏрѕф
­ЪЉе­ЪЈ╗РђЇ­ЪјЊ	рІѕріЋрІх рЅ░рѕЏрѕф: рЅђрѕІрѕЇ рІерЅєрІ│ рЅђрѕѕрѕЮ
­ЪЉе­ЪЈ╝РђЇ­ЪјЊ	рІѕріЋрІх рЅ░рѕЏрѕф: рѕўрѕЃріерѕѕріЏ рЅђрѕІ рІФрѕѕ рІерЅєрІ│ рЅђрѕѕрѕЮ
­ЪЉе­ЪЈйРђЇ­ЪјЊ	рІѕріЋрІх рЅ░рѕЏрѕф: рѕўрѕЃріерѕѕріЏ рІерЅєрІ│ рЅђрѕѕрѕЮ
­ЪЉе­ЪЈЙРђЇ­ЪјЊ	рІѕріЋрІх рЅ░рѕЏрѕф: рѕўрѕЃріерѕѕріЏ-рїЦрЅЂрѕГ рІерЅєрІ│ рЅђрѕѕрѕЮ
­ЪЉе­ЪЈ┐РђЇ­ЪјЊ	рІѕріЋрІх рЅ░рѕЏрѕф: рїЦрЅЂрѕГ рІерЅєрІ│ рЅђрѕѕрѕЮ
­ЪЉЕРђЇ­ЪјЊ	рѕ┤рЅх рЅ░рѕЏрѕф
­ЪЉЕ­ЪЈ╗РђЇ­ЪјЊ	рѕ┤рЅх рЅ░рѕЏрѕф: рЅђрѕІрѕЇ рІерЅєрІ│ рЅђрѕѕрѕЮ
­ЪЉЕ­ЪЈ╝РђЇ­ЪјЊ	рѕ┤рЅх рЅ░рѕЏрѕфрЇА рѕўрѕЃріерѕѕріЏ рЅђрѕІ рІФрѕѕ рІерЅєрІ│ рЅђрѕѕрѕЮ
­ЪЉЕ­ЪЈйРђЇ­ЪјЊ	рѕ┤рЅх рЅ░рѕЏрѕф: рѕўрѕЃріерѕѕріЏ рІерЅєрІ│ рЅђрѕѕрѕЮ
­ЪЉЕ­ЪЈЙРђЇ­ЪјЊ	рѕ┤рЅх рЅ░рѕЏрѕфрЇА рѕўрѕЃріерѕѕріЏ рЅђрѕІ рІФрѕѕ рІерЅєрІ│ рЅђрѕѕрѕЮ
­ЪЉЕ­ЪЈ┐РђЇ­ЪјЊ	рѕ┤рЅх рЅ░рѕЏрѕф: рїЦрЅЂрѕГ рІерЅєрІ│ рЅђрѕѕрѕЮ
­ЪЉеРђЇ­ЪЈФ	рѕ░рІЇ ріарѕхрЅ░рѕЏрѕф
­ЪЉе­ЪЈ╗РђЇ­ЪЈФ	рІѕріЋрІх ріарѕхрЅ░рѕЏрѕф: рЅђрѕІрѕЇ рІерЅєрІ│ рЅђрѕѕрѕЮ
­ЪЉе­ЪЈ╝РђЇ­ЪЈФ	рІѕріЋрІх ріарѕхрЅ░рѕЏрѕф: рѕўрѕЃріерѕѕріЏ рЅђрѕІ рІФрѕѕ рІерЅєрІ│ рЅђрѕѕрѕЮ
­ЪЉе­ЪЈйРђЇ­ЪЈФ	рІѕріЋрІх ріарѕхрЅ░рѕЏрѕф: рѕўрѕЃріерѕѕріЏ рІерЅєрІ│ рЅђрѕѕрѕЮ
­ЪЉе­ЪЈЙРђЇ­ЪЈФ	рІѕріЋрІх ріарѕхрЅ░рѕЏрѕф: рѕўрѕЃріерѕѕріЏ-рїЦрЅЂрѕГ рІерЅєрІ│ рЅђрѕѕрѕЮ
­ЪЉе­ЪЈ┐РђЇ­ЪЈФ	рІѕріЋрІх ріарѕхрЅ░рѕЏрѕф: рїЦрЅЂрѕГ рІерЅєрІ│ рЅђрѕѕрѕЮ
­ЪЉЕРђЇ­ЪЈФ	рѕ┤рЅх рѕўрѕЮрѕЁрѕГ
­ЪЉЕ­ЪЈ╗РђЇ­ЪЈФ	рѕ┤рЅх ріарѕхрЅ░рѕЏрѕф: рЅђрѕІрѕЇ рІерЅєрІ│ рЅђрѕѕрѕЮ
­ЪЉЕ­ЪЈ╝РђЇ­ЪЈФ	рѕ┤рЅх ріарѕхрЅ░рѕЏрѕф: рѕўрѕЃріерѕѕріЏ рЅђрѕІ рІФрѕѕ рІерЅєрІ│ рЅђрѕѕрѕЮ
­ЪЉЕ­ЪЈйРђЇ­ЪЈФ	рѕ┤рЅх ріарѕхрЅ░рѕЏрѕф: рѕўрѕЃріерѕѕріЏ рІерЅєрІ│ рЅђрѕѕрѕЮ
­ЪЉЕ­ЪЈЙРђЇ­ЪЈФ	рѕ┤рЅх рѕўрѕЮрѕЁрѕГрЇА рѕўрѕЃріерѕѕріЏ рЅђрѕІ рІФрѕѕ рІерЅєрІ│ рЅђрѕѕрѕЮ
­ЪЉЕ­ЪЈ┐РђЇ­ЪЈФ	рѕ┤рЅх ріарѕхрЅ░рѕЏрѕф: рїЦрЅЂрѕГ рІерЅєрІ│ рЅђрѕѕрѕЮ
­ЪЉеРђЇРџќ№ИЈ	рѕ░рІЇ рІ│ріЏ
­ЪЉеРђЇРџќ	рѕ░рІЇ рІ│ріЏ
­ЪЉе­ЪЈ╗РђЇРџќ№ИЈ	рѕ░рІЇ рІ│ріЏ: рЅђрѕІрѕЇ рІерЅєрІ│ рЅђрѕѕрѕЮ
­ЪЉе­ЪЈ╗РђЇРџќ	рѕ░рІЇ рІ│ріЏ: рЅђрѕІрѕЇ рІерЅєрІ│ рЅђрѕѕрѕЮ
­ЪЉе­ЪЈ╝РђЇРџќ№ИЈ	рѕ░рІЇ рІ│ріЏ: рѕўрѕЃріерѕѕріЏ рЅђрѕІ рІФрѕѕ рІерЅєрІ│ рЅђрѕѕрѕЮ
­ЪЉе­ЪЈ╝РђЇРџќ	рѕ░рІЇ рІ│ріЏ: рѕўрѕЃріерѕѕріЏ рЅђрѕІ рІФрѕѕ рІерЅєрІ│ рЅђрѕѕрѕЮ
­ЪЉе­ЪЈйРђЇРџќ№ИЈ	рѕ░рІЇ рІ│ріЏ: рѕўрѕЃріерѕѕріЏ рІерЅєрІ│ рЅђрѕѕрѕЮ
­ЪЉе­ЪЈйРђЇРџќ	рѕ░рІЇ рІ│ріЏ: рѕўрѕЃріерѕѕріЏ рІерЅєрІ│ рЅђрѕѕрѕЮ
­ЪЉе­ЪЈЙРђЇРџќ№ИЈ	рѕ░рІЇ рІ│ріЏ: рѕўрѕЃріерѕѕріЏ-рїЦрЅЂрѕГ рІерЅєрІ│ рЅђрѕѕрѕЮ
­ЪЉе­ЪЈЙРђЇРџќ	рѕ░рІЇ рІ│ріЏ: рѕўрѕЃріерѕѕріЏ-рїЦрЅЂрѕГ рІерЅєрІ│ рЅђрѕѕрѕЮ
­ЪЉе­ЪЈ┐РђЇРџќ№ИЈ	рѕ░рІЇ рІ│ріЏ: рїЦрЅЂрѕГ рІерЅєрІ│ рЅђрѕѕрѕЮ
­ЪЉе­ЪЈ┐РђЇРџќ	рѕ░рІЇ рІ│ріЏ: рїЦрЅЂрѕГ рІерЅєрІ│ рЅђрѕѕрѕЮ
­ЪЉЕРђЇРџќ№ИЈ	рѕ┤рЅх рІ│ріЏ
­ЪЉЕРђЇРџќ	рѕ┤рЅх рІ│ріЏ
­ЪЉЕ­ЪЈ╗РђЇРџќ№ИЈ	рѕ┤рЅх рІ│ріЏ: рЅђрѕІрѕЇ рІерЅєрІ│ рЅђрѕѕрѕЮ
­ЪЉЕ­ЪЈ╗РђЇРџќ	рѕ┤рЅх рІ│ріЏ: рЅђрѕІрѕЇ рІерЅєрІ│ рЅђрѕѕрѕЮ
­ЪЉЕ­ЪЈ╝РђЇРџќ№ИЈ	рѕ┤рЅх рІ│ріЏ: рѕўрѕЃріерѕѕріЏ рЅђрѕІ рІФрѕѕ рІерЅєрІ│ рЅђрѕѕрѕЮ
­ЪЉЕ­ЪЈ╝РђЇРџќ	рѕ┤рЅх рІ│ріЏ: рѕўрѕЃріерѕѕріЏ рЅђрѕІ рІФрѕѕ рІерЅєрІ│ рЅђрѕѕрѕЮ
­ЪЉЕ­ЪЈйРђЇРџќ№ИЈ	рѕ┤рЅх рІ│ріЏ: рѕўрѕЃріерѕѕріЏ рІерЅєрІ│ рЅђрѕѕрѕЮ
­ЪЉЕ­ЪЈйРђЇРџќ	рѕ┤рЅх рІ│ріЏ: рѕўрѕЃріерѕѕріЏ рІерЅєрІ│ рЅђрѕѕрѕЮ
­ЪЉЕ­ЪЈЙРђЇРџќ№ИЈ	рѕ┤рЅх рІ│ріЏ: рѕўрѕЃріерѕѕріЏ-рїЦрЅЂрѕГ рІерЅєрІ│ рЅђрѕѕрѕЮ
­ЪЉЕ­ЪЈЙРђЇРџќ	рѕ┤рЅх рІ│ріЏ: рѕўрѕЃріерѕѕріЏ-рїЦрЅЂрѕГ рІерЅєрІ│ рЅђрѕѕрѕЮ
­ЪЉЕ­ЪЈ┐РђЇРџќ№ИЈ	рѕ┤рЅх рІ│ріЏ: рїЦрЅЂрѕГ рІерЅєрІ│ рЅђрѕѕрѕЮ
­ЪЉЕ­ЪЈ┐РђЇРџќ	рѕ┤рЅх рІ│ріЏ: рїЦрЅЂрѕГ рІерЅєрІ│ рЅђрѕѕрѕЮ
­ЪЉеРђЇ­ЪїЙ	рѕ░рІЇ рїѕрЅарѕг
­ЪЉе­ЪЈ╗РђЇ­ЪїЙ	рІѕріЋрІх рїѕрЅарѕгрЇА рЅђрѕІрѕЇ рІерЅєрІ│ рЅђрѕѕрѕЮ
­ЪЉе­ЪЈ╝РђЇ­ЪїЙ	рІѕріЋрІх рїѕрЅарѕгрЇА рѕўрѕЃріерѕѕріЏ рЅђрѕІ рІФрѕѕ рІерЅєрІ│ рЅђрѕѕрѕЮ
­ЪЉе­ЪЈйРђЇ­ЪїЙ	рІѕріЋрІх рїѕрЅарѕг: рѕўрѕЃріерѕѕріЏ рІерЅєрІ│ рЅђрѕѕрѕЮ
­ЪЉе­ЪЈЙРђЇ­ЪїЙ	рѕ░рІЇ рїѕрЅарѕгрЇА рѕўрѕЃріерѕѕріЏ рЅђрѕІ рІФрѕѕ рІерЅєрІ│ рЅђрѕѕрѕЮ
­ЪЉе­ЪЈ┐РђЇ­ЪїЙ	рІѕріЋрІх рїѕрЅарѕг: рїЦрЅЂрѕГ рІерЅєрІ│ рЅђрѕѕрѕЮ
­ЪЉЕРђЇ­ЪїЙ	рѕ┤рЅх рїѕрЅарѕг
­ЪЉЕ­ЪЈ╗РђЇ­ЪїЙ	рѕ┤рЅх рїѕрЅарѕгрЇА рЅђрѕІрѕЇ рІерЅєрІ│ рЅђрѕѕрѕЮ
­ЪЉЕ­ЪЈ╝РђЇ­ЪїЙ	рѕ┤рЅх рїѕрЅарѕгрЇА рѕўрѕЃріерѕѕріЏ рЅђрѕІ рІФрѕѕ рІерЅєрІ│ рЅђрѕѕрѕЮ
­ЪЉЕ­ЪЈйРђЇ­ЪїЙ	рѕ┤рЅх рїѕрЅарѕг: рѕўрѕЃріерѕѕріЏ рІерЅєрІ│ рЅђрѕѕрѕЮ
­ЪЉЕ­ЪЈЙРђЇ­ЪїЙ	рѕ┤рЅх рїѕрЅарѕгрЇА рѕўрѕЃріерѕѕріЏ рЅђрѕІ рІФрѕѕ рІерЅєрІ│ рЅђрѕѕрѕЮ
­ЪЉЕ­ЪЈ┐РђЇ­ЪїЙ	рѕ┤рЅх рїѕрЅарѕг: рїЦрЅЂрѕГ рІерЅєрІ│ рЅђрѕѕрѕЮ
­ЪЉеРђЇ­ЪЇ│	рѕ░рІЇ рѕЏрЅЦрѕ░рѕЇ
­ЪЉе­ЪЈ╗РђЇ­ЪЇ│	рѕ░рІЇ ріарЅЦрѕ│рІГ: рЅђрѕІрѕЇ рІерЅєрІ│ рЅђрѕѕрѕЮ
­ЪЉе­ЪЈ╝РђЇ­ЪЇ│	рѕ░рІЇ ріарЅЦрѕ│рІГ: рѕўрѕЃріерѕѕріЏ рЅђрѕІ рІФрѕѕ рІерЅєрІ│ рЅђрѕѕрѕЮ
­ЪЉе­ЪЈйРђЇ­ЪЇ│	рѕ░рІЇ ріарЅЦрѕ│рІГ: рѕўрѕЃріерѕѕріЏ рІерЅєрІ│ рЅђрѕѕрѕЮ
­ЪЉе­ЪЈЙРђЇ­ЪЇ│	рѕ░рІЇ ріарЅЦрѕ│рІГ: рѕўрѕЃріерѕѕріЏ-рїЦрЅЂрѕГ рІерЅєрІ│ рЅђрѕѕрѕЮ
­ЪЉе­ЪЈ┐РђЇ­ЪЇ│	рѕ░рІЇ ріарЅЦрѕ│рІГ: рїЦрЅЂрѕГ рІерЅєрІ│ рЅђрѕѕрѕЮ
­ЪЉЕРђЇ­ЪЇ│	рѕ┤рЅх рѕЮрїЇрЅЦ ріарІўрїІрїЁ
­ЪЉЕ­ЪЈ╗РђЇ­ЪЇ│	рѕ┤рЅх рѕЮрїЇрЅЦ ріарІўрїІрїЁ: рЅђрѕІрѕЇ рІерЅєрІ│ рЅђрѕѕрѕЮ
­ЪЉЕ­ЪЈ╝РђЇ­ЪЇ│	рѕ┤рЅх рѕЮрїЇрЅЦ ріарІўрїІрїЁ: рѕўрѕЃріерѕѕріЏ рЅђрѕІ рІФрѕѕ рІерЅєрІ│ рЅђрѕѕрѕЮ
­ЪЉЕ­ЪЈйРђЇ­ЪЇ│	рѕ┤рЅх рѕЮрїЇрЅЦ ріарІўрїІрїЁ: рѕўрѕЃріерѕѕріЏ рІерЅєрІ│ рЅђрѕѕрѕЮ
­ЪЉЕ­ЪЈЙРђЇ­ЪЇ│	рѕ┤рЅх рѕЮрїЇрЅЦ ріарІўрїІрїЁ: рѕўрѕЃріерѕѕріЏ-рїЦрЅЂрѕГ рІерЅєрІ│ рЅђрѕѕрѕЮ
­ЪЉЕ­ЪЈ┐РђЇ­ЪЇ│	рѕ┤рЅх рѕЮрїЇрЅЦ ріарІўрїІрїЁ: рїЦрЅЂрѕГ рІерЅєрІ│ рЅђрѕѕрѕЮ
­ЪЉеРђЇ­ЪћД	рѕ░рІЇ рѕўріФріњріГ
­ЪЉе­ЪЈ╗РђЇ­ЪћД	рѕ░рІЇ рѕюріФріњріГ: рЅђрѕІрѕЇ рІерЅєрІ│ рЅђрѕѕрѕЮ
­ЪЉе­ЪЈ╝РђЇ­ЪћД	рІѕріЋрІх рѕюріФріњріГ: рѕўрѕЃріерѕѕріЏ рЅђрѕІ рІФрѕѕ рІерЅєрІ│ рЅђрѕѕрѕЮ
­ЪЉе­ЪЈйРђЇ­ЪћД	рІѕріЋрІх рѕюріФріњріГ: рѕўрѕЃріерѕѕріЏ рІерЅєрІ│ рЅђрѕѕрѕЮ
­ЪЉе­ЪЈЙРђЇ­ЪћД	рѕ░рІЇ рѕюріФріњріГ: рѕўрѕЃріерѕѕріЏ-рїЦрЅЂрѕГ рІерЅєрІ│ рЅђрѕѕрѕЮ
­ЪЉе­ЪЈ┐РђЇ­ЪћД	рІѕріЋрІх рѕюріФріњріГ: рїЦрЅЂрѕГ рІерЅєрІ│ рЅђрѕѕрѕЮ
­ЪЉЕРђЇ­ЪћД	рѕ┤рЅх рѕўріФріњріГ
­ЪЉЕ­ЪЈ╗РђЇ­ЪћД	рѕ┤рЅх рѕюріФріњріГ: рЅђрѕІрѕЇ рІерЅєрІ│ рЅђрѕѕрѕЮ
­ЪЉЕ­ЪЈ╝РђЇ­ЪћД	рѕ┤рЅх рѕюріФріњріГ: рѕўрѕЃріерѕѕріЏ рЅђрѕІ рІФрѕѕ рІерЅєрІ│ рЅђрѕѕрѕЮ
­ЪЉЕ­ЪЈйРђЇ­ЪћД	рѕ┤рЅх рѕюріФріњріГ: рѕўрѕЃріерѕѕріЏ рІерЅєрІ│ рЅђрѕѕрѕЮ
­ЪЉЕ­ЪЈЙРђЇ­ЪћД	рѕ┤рЅх рѕўріФріњріГ: рѕўрѕЃріерѕѕріЏ рЅђрѕІ рІФрѕѕ рІерЅєрІ│ рЅђрѕѕрѕЮ
­ЪЉЕ­ЪЈ┐РђЇ­ЪћД	рѕ┤рЅх рѕюріФріњріГ: рїЦрЅЂрѕГ рІерЅєрІ│ рЅђрѕѕрѕЮ
­ЪЉеРђЇ­ЪЈГ	рѕ░рІЇ рІерЇІрЅЦрѕфріФ рѕ░рѕФрЅ░ріЏ
­ЪЉе­ЪЈ╗РђЇ­ЪЈГ	рІѕріЋрІх рІерЇІрЅЦрѕфріФ рѕ░рѕФрЅ░ріЏ: рЅђрѕІрѕЇ рІерЅєрІ│ рЅђрѕѕрѕЮ
­ЪЉе­ЪЈ╝РђЇ­ЪЈГ	рІѕріЋрІх рІерЇІрЅЦрѕфріФ рѕ░рѕФрЅ░ріЏрЇА рѕўрѕЃріерѕѕріЏ рЅђрѕІ рІФрѕѕ рІерЅєрІ│ рЅђрѕѕрѕЮ
­ЪЉе­ЪЈйРђЇ­ЪЈГ	рІѕріЋрІх рІерЇІрЅЦрѕфріФ рѕ░рѕФрЅ░ріЏ: рѕўрѕЃріерѕѕріЏ рІерЅєрІ│ рЅђрѕѕрѕЮ
­ЪЉе­ЪЈЙРђЇ­ЪЈГ	рІѕріЋрІх рІерЇІрЅЦрѕфріФ рѕ░рѕФрЅ░ріЏрЇА рѕўрѕЃріерѕѕріЏ рЅђрѕІ рІФрѕѕ рІерЅєрІ│ рЅђрѕѕрѕЮ
­ЪЉе­ЪЈ┐РђЇ­ЪЈГ	рІѕріЋрІх рІерЇІрЅЦрѕфріФ рѕ░рѕФрЅ░ріЏ: рїЦрЅЂрѕГ рІерЅєрІ│ рЅђрѕѕрѕЮ
­ЪЉЕРђЇ­ЪЈГ	рѕ┤рЅх рІерЇІрЅЦрѕфріФ рѕ░рѕФрЅ░ріЏ
­ЪЉЕ­ЪЈ╗РђЇ­ЪЈГ	рѕ┤рЅх рІерЇІрЅЦрѕфріФ рѕ░рѕФрЅ░ріЏрЇА рЅђрѕІрѕЇ рІерЅєрІ│ рЅђрѕѕрѕЮ
­ЪЉЕ­ЪЈ╝РђЇ­ЪЈГ	рѕ┤рЅх рІерЇІрЅЦрѕфріФ рѕ░рѕФрЅ░ріЏрЇА рѕўрѕЃріерѕѕріЏ рЅђрѕІ рІФрѕѕ рІерЅєрІ│ рЅђрѕѕрѕЮ
­ЪЉЕ­ЪЈйРђЇ­ЪЈГ	рѕ┤рЅх рІерЇІрЅЦрѕфріФ рѕ░рѕФрЅ░ріЏ: рѕўрѕЃріерѕѕріЏ рІерЅєрІ│ рЅђрѕѕрѕЮ
­ЪЉЕ­ЪЈЙРђЇ­ЪЈГ	рѕ┤рЅх рІерЇІрЅЦрѕфріФ рѕ░рѕФрЅ░ріЏрЇА рѕўрѕЃріерѕѕріЏ рЅђрѕІ рІФрѕѕ рІерЅєрІ│ рЅђрѕѕрѕЮ
­ЪЉЕ­ЪЈ┐РђЇ­ЪЈГ	рѕ┤рЅх рІерЇІрЅЦрѕфріФ рѕ░рѕФрЅ░ріЏ: рїЦрЅЂрѕГ рІерЅєрІ│ рЅђрѕѕрѕЮ
­ЪЉеРђЇ­Ъњ╝	рѕ░рІЇ рІерЅбрѕ« рѕ░рѕФрЅ░ріЏ
­ЪЉе­ЪЈ╗РђЇ­Ъњ╝	рІѕріЋрІх рІерЅбрѕ« рѕ░рѕФрЅ░ріЏ: рЅђрѕІрѕЇ рІерЅєрІ│ рЅђрѕѕрѕЮ
­ЪЉе­ЪЈ╝РђЇ­Ъњ╝	рІѕріЋрІх рІерЅбрѕ« рѕ░рѕФрЅ░ріЏ: рѕўрѕЃріерѕѕріЏ рЅђрѕІ рІФрѕѕ рІерЅєрІ│ рЅђрѕѕрѕЮ
­ЪЉе­ЪЈйРђЇ­Ъњ╝	рІѕріЋрІх рІерЅбрѕ« рѕ░рѕФрЅ░ріЏ: рѕўрѕЃріерѕѕріЏ рІерЅєрІ│ рЅђрѕѕрѕЮ
­ЪЉе­ЪЈЙРђЇ­Ъњ╝	рІѕріЋрІх рІерЅбрѕ« рѕ░рѕФрЅ░ріЏ: рѕўрѕЃріерѕѕріЏ рЅђрѕІ рІФрѕѕ рІерЅєрІ│ рЅђрѕѕрѕЮ
­ЪЉе­ЪЈ┐РђЇ­Ъњ╝	рІѕріЋрІх рІерЅбрѕ« рѕ░рѕФрЅ░ріЏ: рїЦрЅЂрѕГ рІерЅєрІ│ рЅђрѕѕрѕЮ
­ЪЉЕРђЇ­Ъњ╝	рѕ┤рЅх рІерЅбрѕ« рѕ░рѕФрЅ░ріЏ
­ЪЉЕ­ЪЈ╗РђЇ­Ъњ╝	рѕ┤рЅх рІерЅбрѕ« рѕ░рѕФрЅ░ріЏрЇА рЅђрѕІрѕЇ рІерЅєрІ│ рЅђрѕѕрѕЮ
­ЪЉЕ­ЪЈ╝РђЇ­Ъњ╝	рѕ┤рЅх рІерЅбрѕ« рѕ░рѕФрЅ░ріЏрЇА рѕўрѕЃріерѕѕріЏ рЅђрѕІ рІФрѕѕ рІерЅєрІ│ рЅђрѕѕрѕЮ
­ЪЉЕ­ЪЈйРђЇ­Ъњ╝	рѕ┤рЅх рІерЅбрѕ« рѕ░рѕФрЅ░ріЏ: рѕўрѕЃріерѕѕріЏ рІерЅєрІ│ рЅђрѕѕрѕЮ
­ЪЉЕ­ЪЈЙРђЇ­Ъњ╝	рѕ┤рЅх рІерЅбрѕ« рѕ░рѕФрЅ░ріЏрЇА рѕўрѕЃріерѕѕріЏ рЅђрѕІ рІФрѕѕ рІерЅєрІ│ рЅђрѕѕрѕЮ
­ЪЉЕ­ЪЈ┐РђЇ­Ъњ╝	рѕ┤рЅх рІерЅбрѕ« рѕ░рѕФрЅ░ріЏ: рїЦрЅЂрѕГ рІерЅєрІ│ рЅђрѕѕрѕЮ
­ЪЉеРђЇ­Ъћг	рѕ░рІЇ рѕ│рІГріЋрЅ▓рѕхрЅх
­ЪЉе­ЪЈ╗РђЇ­Ъћг	рѕ░рІЇ рѕ│рІГріЋрЅ▓рѕхрЅх: рЅђрѕІрѕЇ рІерЅєрІ│ рЅђрѕѕрѕЮ
­ЪЉе­ЪЈ╝РђЇ­Ъћг	рѕ░рІЇ рѕ│рІГріЋрЅ▓рѕхрЅх: рѕўрѕЃріерѕѕріЏ рЅђрѕІ рІФрѕѕ рІерЅєрІ│ рЅђрѕѕрѕЮ
­ЪЉе­ЪЈйРђЇ­Ъћг	рѕ░рІЇ рѕ│рІГріЋрЅ▓рѕхрЅх: рѕўрѕЃріерѕѕріЏ рІерЅєрІ│ рЅђрѕѕрѕЮ
­ЪЉе­ЪЈЙРђЇ­Ъћг	рѕ░рІЇ рѕ│рІГріЋрЅ▓рѕхрЅх: рѕўрѕЃріерѕѕріЏ-рїЦрЅЂрѕГ рІерЅєрІ│ рЅђрѕѕрѕЮ
­ЪЉе­ЪЈ┐РђЇ­Ъћг	рѕ░рІЇ рѕ│рІГріЋрЅ▓рѕхрЅх: рїЦрЅЂрѕГ рІерЅєрІ│ рЅђрѕѕрѕЮ
­ЪЉЕРђЇ­Ъћг	рѕ┤рЅх рѕ│рІГріЋрЅ▓рѕхрЅх
­ЪЉЕ­ЪЈ╗РђЇ­Ъћг	рѕ┤рЅх рѕ│рІГріЋрЅ▓рѕхрЅх: рЅђрѕІрѕЇ рІерЅєрІ│ рЅђрѕѕрѕЮ
­ЪЉЕ­ЪЈ╝РђЇ­Ъћг	рѕ┤рЅх рѕ│рІГріЋрЅ▓рѕхрЅх: рѕўрѕЃріерѕѕріЏ рЅђрѕІ рІФрѕѕ рІерЅєрІ│ рЅђрѕѕрѕЮ
­ЪЉЕ­ЪЈйРђЇ­Ъћг	рѕ┤рЅх рѕ│рІГріЋрЅ▓рѕхрЅх: рѕўрѕЃріерѕѕріЏ рІерЅєрІ│ рЅђрѕѕрѕЮ
­ЪЉЕ­ЪЈЙРђЇ­Ъћг	рѕ┤рЅх рѕ│рІГріЋрЅ▓рѕхрЅх: рѕўрѕЃріерѕѕріЏ рЅђрѕІ рІФрѕѕ рІерЅєрІ│ рЅђрѕѕрѕЮ
­ЪЉЕ­ЪЈ┐РђЇ­Ъћг	рѕ┤рЅх рѕ│рІГріЋрЅ▓рѕхрЅх: рїЦрЅЂрѕГ рІерЅєрІ│ рЅђрѕѕрѕЮ
­ЪЉеРђЇ­Ъњ╗	рѕ░рІЇ рЅ┤ріГріќрѕјрїЁрѕхрЅх
­ЪЉе­ЪЈ╗РђЇ­Ъњ╗	рѕ░рІЇ рЅ┤ріГріќрѕјрїѓрѕхрЅх: рЅђрѕІрѕЇ рІерЅєрІ│ рЅђрѕѕрѕЮ
­ЪЉе­ЪЈ╝РђЇ­Ъњ╗	рѕ░рІЇ рЅ┤ріГріќрѕјрїѓрѕхрЅх: рѕўрѕЃріерѕѕріЏ рЅђрѕІ рІФрѕѕ рІерЅєрІ│ рЅђрѕѕрѕЮ
­ЪЉе­ЪЈйРђЇ­Ъњ╗	рѕ░рІЇ рЅ┤ріГріќрѕјрїѓрѕхрЅх: рѕўрѕЃріерѕѕріЏ рІерЅєрІ│ рЅђрѕѕрѕЮ
­ЪЉе­ЪЈЙРђЇ­Ъњ╗	рѕ░рІЇ рЅ┤ріГріќрѕјрїѓрѕхрЅхрЇА рѕўрѕЃріерѕѕріЏ рЅђрѕІ рІФрѕѕ рІерЅєрІ│ рЅђрѕѕрѕЮ
­ЪЉе­ЪЈ┐РђЇ­Ъњ╗	рѕ░рІЇ рЅ┤ріГріќрѕјрїѓрѕхрЅх: рїЦрЅЂрѕГ рІерЅєрІ│ рЅђрѕѕрѕЮ
­ЪЉЕРђЇ­Ъњ╗	рѕ┤рЅх рІерЅ┤ріГріќрѕјрїѓ рЅБрѕѕрѕЎрІФ
­ЪЉЕ­ЪЈ╗РђЇ­Ъњ╗	рѕ┤рЅх рЅ┤ріГріќрѕјрїЁ: рЅђрѕІрѕЇ рІерЅєрІ│ рЅђрѕѕрѕЮ
­ЪЉЕ­ЪЈ╝РђЇ­Ъњ╗	рѕ┤рЅх рЅ┤ріГріќрѕјрїЁрѕхрЅхрЇА рѕўрѕЃріерѕѕріЏ рЅђрѕІ рІФрѕѕ рІерЅєрІ│ рЅђрѕѕрѕЮ
­ЪЉЕ­ЪЈйРђЇ­Ъњ╗	рѕ┤рЅх рЅ┤ріГріќрѕјрїѓрѕхрЅх: рѕўрѕЃріерѕѕріЏ рІерЅєрІ│ рЅђрѕѕрѕЮ
­ЪЉЕ­ЪЈЙРђЇ­Ъњ╗	рѕ┤рЅх рЅ┤ріГріќрѕјрїЁрѕхрЅхрЇА рѕўрѕЃріерѕѕріЏ рЅђрѕІ рІФрѕѕ рІерЅєрІ│ рЅђрѕѕрѕЮ
­ЪЉЕ­ЪЈ┐РђЇ­Ъњ╗	рѕ┤рЅх рЅ┤ріГріќрѕјрїЁ: рїЦрЅЂрѕГ рІерЅєрІ│ рЅђрѕѕрѕЮ
­ЪЉеРђЇ­Ъјц	рѕ░рІЇ рІўрЇІріЮ
­ЪЉе­ЪЈ╗РђЇ­Ъјц	рІѕріЋрІх рІўрЇІріЮ: рЅђрѕІрѕЇ рІерЅєрІ│ рЅђрѕѕрѕЮ
­ЪЉе­ЪЈ╝РђЇ­Ъјц	рІѕріЋрІх рІўрЇІріЮ: рѕўрѕЃріерѕѕріЏ рЅђрѕІ рІФрѕѕ рІерЅєрІ│ рЅђрѕѕрѕЮ
­ЪЉе­ЪЈйРђЇ­Ъјц	рІѕріЋрІх рІўрЇІріЮ: рѕўрѕЃріерѕѕріЏ рІерЅєрІ│ рЅђрѕѕрѕЮ
­ЪЉе­ЪЈЙРђЇ­Ъјц	рІѕріЋрІх рІўрЇІріЮ: рѕўрѕЃріерѕѕріЏ-рїЦрЅЂрѕГ рІерЅєрІ│ рЅђрѕѕрѕЮ
­ЪЉе­ЪЈ┐РђЇ­Ъјц	рІѕріЋрІх рІўрЇІріЮ: рїЦрЅЂрѕГ рІерЅєрІ│ рЅђрѕѕрѕЮ
­ЪЉЕРђЇ­Ъјц	рѕ┤рЅх рІўрЇІріЮ
­ЪЉЕ­ЪЈ╗РђЇ­Ъјц	рѕ┤рЅх рІўрЇІріЮ: рЅђрѕІрѕЇ рІерЅєрІ│ рЅђрѕѕрѕЮ
­ЪЉЕ­ЪЈ╝РђЇ­Ъјц	рѕ┤рЅх рІўрЇІріЮ: рѕўрѕЃріерѕѕріЏ рЅђрѕІ рІФрѕѕ рІерЅєрІ│ рЅђрѕѕрѕЮ
­ЪЉЕ­ЪЈйРђЇ­Ъјц	рѕ┤рЅх рІўрЇІріЮ: рѕўрѕЃріерѕѕріЏ рІерЅєрІ│ рЅђрѕѕрѕЮ
­ЪЉЕ­ЪЈЙРђЇ­Ъјц	рѕ┤рЅх рІўрЇІріЮрЇА рѕўрѕЃріерѕѕріЏ рЅђрѕІ рІФрѕѕ рІерЅєрІ│ рЅђрѕѕрѕЮ
­ЪЉЕ­ЪЈ┐РђЇ­Ъјц	рѕ┤рЅх рІўрЇІріЮ: рїЦрЅЂрѕГ рІерЅєрІ│ рЅђрѕѕрѕЮ
­ЪЉеРђЇ­Ъје	рѕ░рІЇ ріарѕГрЅ▓рѕхрЅх
­ЪЉе­ЪЈ╗РђЇ­Ъје	рІѕріЋрІх ріарѕГрЅ▓рѕхрЅх: рЅђрѕІрѕЇ рІерЅєрІ│ рЅђрѕѕрѕЮ
­ЪЉе­ЪЈ╝РђЇ­Ъје	рІѕріЋрІх ріарѕГрЅ▓рѕхрЅх: рѕўрѕЃріерѕѕріЏ рЅђрѕІ рІФрѕѕ рІерЅєрІ│ рЅђрѕѕрѕЮ
­ЪЉе­ЪЈйРђЇ­Ъје	рІѕріЋрІх ріарѕГрЅ▓рѕхрЅх: рѕўрѕЃріерѕѕріЏ рІерЅєрІ│ рЅђрѕѕрѕЮ
­ЪЉе­ЪЈЙРђЇ­Ъје	рІѕріЋрІх ріарѕГрЅ▓рѕхрЅх: рѕўрѕЃріерѕѕріЏ-рїЦрЅЂрѕГ рІерЅєрІ│ рЅђрѕѕрѕЮ
­ЪЉе­ЪЈ┐РђЇ­Ъје	рІѕріЋрІх ріарѕГрЅ▓рѕхрЅх: рїЦрЅЂрѕГ рІерЅєрІ│ рЅђрѕѕрѕЮ
­ЪЉЕРђЇ­Ъје	рѕ┤рЅх ріарѕГрЅ▓рѕхрЅх
­ЪЉЕ­ЪЈ╗РђЇ­Ъје	рѕ┤рЅх ріарѕГрЅ▓рѕхрЅх: рЅђрѕІрѕЇ рІерЅєрІ│ рЅђрѕѕрѕЮ
­ЪЉЕ­ЪЈ╝РђЇ­Ъје	рѕ┤рЅх ріарѕГрЅ▓рѕхрЅх: рѕўрѕЃріерѕѕріЏ рЅђрѕІ рІФрѕѕ рІерЅєрІ│ рЅђрѕѕрѕЮ
­ЪЉЕ­ЪЈйРђЇ­Ъје	рѕ┤рЅх ріарѕГрЅ▓рѕхрЅх: рѕўрѕЃріерѕѕріЏ рІерЅєрІ│ рЅђрѕѕрѕЮ
­ЪЉЕ­ЪЈЙРђЇ­Ъје	рѕ┤рЅх ріарѕГрЅ▓рѕхрЅх: рѕўрѕЃріерѕѕріЏ рЅђрѕІ рІФрѕѕ рІерЅєрІ│ рЅђрѕѕрѕЮ
­ЪЉЕ­ЪЈ┐РђЇ­Ъје	рѕ┤рЅх ріарѕГрЅ▓рѕхрЅх: рїЦрЅЂрѕГ рІерЅєрІ│ рЅђрѕѕрѕЮ
­ЪЉеРђЇРюѕ№ИЈ	рѕ░рІЇ ріарЅЦрѕФрѕф
­ЪЉеРђЇРюѕ	рѕ░рІЇ ріарЅЦрѕФрѕф
­ЪЉе­ЪЈ╗РђЇРюѕ№ИЈ	рѕ░рІЇ ріарЅЦрѕФрѕф: рЅђрѕІрѕЇ рІерЅєрІ│ рЅђрѕѕрѕЮ
­ЪЉе­ЪЈ╗РђЇРюѕ	рѕ░рІЇ ріарЅЦрѕФрѕф: рЅђрѕІрѕЇ рІерЅєрІ│ рЅђрѕѕрѕЮ
­ЪЉе­ЪЈ╝РђЇРюѕ№ИЈ	рІѕріЋрІх ріарЅЦрѕФрѕфрЇА рѕўрѕЃріерѕѕріЏ рЅђрѕІ рІФрѕѕ рІерЅєрІ│ рЅђрѕѕрѕЮ
­ЪЉе­ЪЈ╝РђЇРюѕ	рІѕріЋрІх ріарЅЦрѕФрѕфрЇА рѕўрѕЃріерѕѕріЏ рЅђрѕІ рІФрѕѕ рІерЅєрІ│ рЅђрѕѕрѕЮ
­ЪЉе­ЪЈйРђЇРюѕ№ИЈ	рѕ░рІЇ ріарЅЦрѕФрѕф: рѕўрѕЃріерѕѕріЏ рІерЅєрІ│ рЅђрѕѕрѕЮ
­ЪЉе­ЪЈйРђЇРюѕ	рѕ░рІЇ ріарЅЦрѕФрѕф: рѕўрѕЃріерѕѕріЏ рІерЅєрІ│ рЅђрѕѕрѕЮ
­ЪЉе­ЪЈЙРђЇРюѕ№ИЈ	рІѕріЋрІх ріарЅЦрѕФрѕфрЇА рѕўрѕЃріерѕѕріЏ рЅђрѕІ рІФрѕѕ рІерЅєрІ│ рЅђрѕѕрѕЮ
­ЪЉе­ЪЈЙРђЇРюѕ	рІѕріЋрІх ріарЅЦрѕФрѕфрЇА рѕўрѕЃріерѕѕріЏ рЅђрѕІ рІФрѕѕ рІерЅєрІ│ рЅђрѕѕрѕЮ
­ЪЉе­ЪЈ┐РђЇРюѕ№ИЈ	рѕ░рІЇ ріарЅЦрѕФрѕф: рїЦрЅЂрѕГ рІерЅєрІ│ рЅђрѕѕрѕЮ
­ЪЉе­ЪЈ┐РђЇРюѕ	рѕ░рІЇ ріарЅЦрѕФрѕф: рїЦрЅЂрѕГ рІерЅєрІ│ рЅђрѕѕрѕЮ
­ЪЉЕРђЇРюѕ№ИЈ	рѕ┤рЅх ріарЅЦрѕФрѕф
­ЪЉЕРђЇРюѕ	рѕ┤рЅх ріарЅЦрѕФрѕф
­ЪЉЕ­ЪЈ╗РђЇРюѕ№ИЈ	рѕ┤рЅх ріарЅЦрѕФрѕфрЇА рЅђрѕІрѕЇ рІерЅєрІ│ рЅђрѕѕрѕЮ
­ЪЉЕ­ЪЈ╗РђЇРюѕ	рѕ┤рЅх ріарЅЦрѕФрѕфрЇА рЅђрѕІрѕЇ рІерЅєрІ│ рЅђрѕѕрѕЮ
­ЪЉЕ­ЪЈ╝РђЇРюѕ№ИЈ	рѕ┤рЅх ріарЅЦрѕФрѕфрЇА рѕўрѕЃріерѕѕріЏ рЅђрѕІ рІФрѕѕ рІерЅєрІ│ рЅђрѕѕрѕЮ
­ЪЉЕ­ЪЈ╝РђЇРюѕ	рѕ┤рЅх ріарЅЦрѕФрѕфрЇА рѕўрѕЃріерѕѕріЏ рЅђрѕІ рІФрѕѕ рІерЅєрІ│ рЅђрѕѕрѕЮ
­ЪЉЕ­ЪЈйРђЇРюѕ№ИЈ	рѕ┤рЅх ріарЅЦрѕФрѕфрЇА рѕўрѕЃріерѕѕріЏ рІерЅєрІ│ рЅђрѕѕрѕЮ
­ЪЉЕ­ЪЈйРђЇРюѕ	рѕ┤рЅх ріарЅЦрѕФрѕфрЇА рѕўрѕЃріерѕѕріЏ рІерЅєрІ│ рЅђрѕѕрѕЮ
­ЪЉЕ­ЪЈЙРђЇРюѕ№ИЈ	рѕ┤рЅх ріарЅЦрѕФрѕфрЇА рѕўрѕЃріерѕѕріЏ рЅђрѕІ рІФрѕѕ рІерЅєрІ│ рЅђрѕѕрѕЮ
­ЪЉЕ­ЪЈЙРђЇРюѕ	рѕ┤рЅх ріарЅЦрѕФрѕфрЇА рѕўрѕЃріерѕѕріЏ рЅђрѕІ рІФрѕѕ рІерЅєрІ│ рЅђрѕѕрѕЮ
­ЪЉЕ­ЪЈ┐РђЇРюѕ№ИЈ	рѕ┤рЅх ріарЅЦрѕФрѕф: рїЦрЅЂрѕГ рІерЅєрІ│ рЅђрѕѕрѕЮ
­ЪЉЕ­ЪЈ┐РђЇРюѕ	рѕ┤рЅх ріарЅЦрѕФрѕф: рїЦрЅЂрѕГ рІерЅєрІ│ рЅђрѕѕрѕЮ
­ЪЉеРђЇ­Ъџђ	рѕ░рІЇ рІерїарЇѕрѕГ рЅ░рѕўрѕФрѕЏрѕф
­ЪЉе­ЪЈ╗РђЇ­Ъџђ	рѕ░рІЇ рІерїарЇѕрѕГ рЅ░рѕўрѕФрѕЏрѕфрЇА рЅђрѕІрѕЇ рІерЅєрІ│ рЅђрѕѕрѕЮ
­ЪЉе­ЪЈ╝РђЇ­Ъџђ	рѕ░рІЇ рІерїарЇѕрѕГ рЅ░рѕўрѕФрѕЏрѕфрЇА рѕўрѕЃріерѕѕріЏ рЅђрѕІ рІФрѕѕ рІерЅєрІ│ рЅђрѕѕрѕЮ
­ЪЉе­ЪЈйРђЇ­Ъџђ	рѕ░рІЇ рІерїарЇѕрѕГ рЅ░рѕўрѕФрѕЏрѕфрЇА рѕўрѕЃріерѕѕріЏ рІерЅєрІ│ рЅђрѕѕрѕЮ
­ЪЉе­ЪЈЙРђЇ­Ъџђ	рѕ░рІЇ рІерїарЇѕрѕГ рЅ░рѕўрѕФрѕЏрѕфрЇА рѕўрѕЃріерѕѕріЏ рЅђрѕІ рІФрѕѕ рІерЅєрІ│ рЅђрѕѕрѕЮ
­ЪЉе­ЪЈ┐РђЇ­Ъџђ	рѕ░рІЇ рІерїарЇѕрѕГ рЅ░рѕўрѕФрѕЏрѕфрЇА рїЦрЅЂрѕГ рІерЅєрІ│ рЅђрѕѕрѕЮ
­ЪЉЕРђЇ­Ъџђ	рѕ┤рЅх рїарЇѕрѕГрЅ░ріЏ
­ЪЉЕ­ЪЈ╗РђЇ­Ъџђ	рѕ┤рЅх рІерїарЇѕрѕГ рЅ░рѕўрѕФрѕЏрѕфрЇА рЅђрѕІрѕЇ рІерЅєрІ│ рЅђрѕѕрѕЮ
­ЪЉЕ­ЪЈ╝РђЇ­Ъџђ	рѕ┤рЅх рІерїарЇѕрѕГ рЅ░рѕўрѕФрѕЏрѕфрЇА рѕўрѕЃріерѕѕріЏ рЅђрѕІ рІФрѕѕ рІерЅєрІ│ рЅђрѕѕрѕЮ
­ЪЉЕ­ЪЈйРђЇ­Ъџђ	рѕ┤рЅх рІерїарЇѕрѕГ рЅ░рѕўрѕФрѕЏрѕфрЇА рѕўрѕЃріерѕѕріЏ рІерЅєрІ│ рЅђрѕѕрѕЮ
­ЪЉЕ­ЪЈЙРђЇ­Ъџђ	рѕ┤рЅх рІерїарЇѕрѕГ рЅ░рѕўрѕФрѕЏрѕфрЇА рѕўрѕЃріерѕѕріЏ рЅђрѕІ рІФрѕѕ рІерЅєрІ│ рЅђрѕѕрѕЮ
­ЪЉЕ­ЪЈ┐РђЇ­Ъџђ	рѕ┤рЅх рїарЇѕрѕГрЅ░ріЏ: рїЦрЅЂрѕГ рІерЅєрІ│ рЅђрѕѕрѕЮ
­ЪЉеРђЇ­Ъџњ	рѕ░рІЇ рІеріЦрѕ│рЅх ріарІ░рїІ рѕўріерѕІріерІФ рѕарѕФрЅ░ріЏ
­ЪЉе­ЪЈ╗РђЇ­Ъџњ	рѕ░рІЇ рІеріЦрѕ│рЅх ріарІ░рїІ рѕўріерѕІріерІФ рѕарѕФрЅ░ріЏ: рЅђрѕІрѕЇ рІерЅєрІ│ рЅђрѕѕрѕЮ
­ЪЉе­ЪЈ╝РђЇ­Ъџњ	рѕ░рІЇ рІеріЦрѕ│рЅх ріарІ░рїІ рѕўріерѕІріерІФ: рѕўрѕЃріерѕѕріЏ рЅђрѕІ рІФрѕѕ рІерЅєрІ│ рЅђрѕѕрѕЮ
­ЪЉе­ЪЈйРђЇ­Ъџњ	рѕ░рІЇ рІеріЦрѕ│рЅх ріарІ░рїІ рѕўріерѕІріерІФ: рѕўрѕЃріерѕѕріЏ рІерЅєрІ│ рЅђрѕѕрѕЮ
­ЪЉе­ЪЈЙРђЇ­Ъџњ	рІеріЦрѕ│рЅх ріарІ░рїІ рѕўріерѕІріерІФ рѕ░рІЇ: рѕўрѕЃріерѕѕріЏ рЅђрѕІ рІФрѕѕ рІерЅєрІ│ рЅђрѕѕрѕЮ
­ЪЉе­ЪЈ┐РђЇ­Ъџњ	рѕ░рІЇ рІеріЦрѕ│рЅх ріарІ░рїІ рѕўріерѕІріерІФ: рїЦрЅЂрѕГ рІерЅєрІ│ рЅђрѕѕрѕЮ
­ЪЉЕРђЇ­Ъџњ	рѕ┤рЅх рІеріЦрѕ│рЅх ріарІ░рїІ рѕўріерѕІріерІФ рѕарѕФрЅ░ріЏ
­ЪЉЕ­ЪЈ╗РђЇ­Ъџњ	рѕ┤рЅх рІеріЦрѕ│рЅх ріарІ░рїІ рѕўріерѕІріерІФ рѕарѕФрЅ░ріЏ: рЅђрѕІрѕЇ рІерЅєрІ│ рЅђрѕѕрѕЮ
­ЪЉЕ­ЪЈ╝РђЇ­Ъџњ	рѕ┤рЅх рІеріЦрѕ│рЅх ріарІ░рїІ рѕўріерѕІріерІФ: рѕўрѕЃріерѕѕріЏ рЅђрѕІ рІФрѕѕ рІерЅєрІ│ рЅђрѕѕрѕЮ
­ЪЉЕ­ЪЈйРђЇ­Ъџњ	рѕ┤рЅх рІеріЦрѕ│рЅх ріарІ░рїІ рѕўріерѕІріерІФ: рѕўрѕЃріерѕѕріЏ рІерЅєрІ│ рЅђрѕѕрѕЮ
­ЪЉЕ­ЪЈЙРђЇ­Ъџњ	рѕ┤рЅх рІеріЦрѕ│рЅх ріарІ░рїІ рѕўріерѕІріерІФ рѕарѕФрЅ░ріЏ: рѕўрѕЃріерѕѕріЏ рЅђрѕІ рІФрѕѕ рІерЅєрІ│ рЅђрѕѕрѕЮ
­ЪЉЕ­ЪЈ┐РђЇ­Ъџњ	рѕ┤рЅх рІеріЦрѕ│рЅх ріарІ░рїІ рѕўріерѕІріерІФ: рїЦрЅЂрѕГ рІерЅєрІ│ рЅђрѕѕрѕЮ
­ЪЉ«	рЇќрѕірѕх рѕўрі«ріЋ
­ЪЉ«­ЪЈ╗	рІерЇќрѕірѕх рѕўрі«ріЋріЋ: рЅђрѕІрѕЇ рІерЅєрІ│ рЅђрѕѕрѕЮ
­ЪЉ«­ЪЈ╝	рЇќрѕірѕх рѕўрі«ріЋріЋрЇА рѕўрѕЃріерѕѕріЏ рЅђрѕІ рІФрѕѕ рІерЅєрІ│ рЅђрѕѕрѕЮ
­ЪЉ«­ЪЈй	рІерЇќрѕірѕх рѕўрі«ріЋріЋ: рѕўрѕЃріерѕѕріЏ рІерЅєрІ│ рЅђрѕѕрѕЮ
­ЪЉ«­ЪЈЙ	рІерЇќрѕірѕх рѕўрі«ріЋріЋрЇА рѕўрѕЃріерѕѕріЏ рЅђрѕІ рІФрѕѕ рІерЅєрІ│ рЅђрѕѕрѕЮ
­ЪЉ«­ЪЈ┐	рІерЇќрѕірѕх рѕўрі«ріЋріЋ: рїЦрЅЂрѕГ рІерЅєрІ│ рЅђрѕѕрѕЮ
­ЪЉ«РђЇРЎѓ№ИЈ	рІѕріЋрІх рЇќрѕірѕх
­ЪЉ«РђЇРЎѓ	рІѕріЋрІх рЇќрѕірѕх
­ЪЉ«­ЪЈ╗РђЇРЎѓ№ИЈ	рІѕріЋрІх рЇќрѕірѕх: рЅђрѕІрѕЇ рІерЅєрІ│ рЅђрѕѕрѕЮ
­ЪЉ«­ЪЈ╗РђЇРЎѓ	рІѕріЋрІх рЇќрѕірѕх: рЅђрѕІрѕЇ рІерЅєрІ│ рЅђрѕѕрѕЮ
­ЪЉ«­ЪЈ╝РђЇРЎѓ№ИЈ	рІѕріЋрІх рЇќрѕірѕх: рѕўрѕЃріерѕѕріЏ рЅђрѕІ рІФрѕѕ рІерЅєрІ│ рЅђрѕѕрѕЮ
­ЪЉ«­ЪЈ╝РђЇРЎѓ	рІѕріЋрІх рЇќрѕірѕх: рѕўрѕЃріерѕѕріЏ рЅђрѕІ рІФрѕѕ рІерЅєрІ│ рЅђрѕѕрѕЮ
­ЪЉ«­ЪЈйРђЇРЎѓ№ИЈ	рІѕріЋрІх рЇќрѕірѕх: рѕўрѕЃріерѕѕріЏ рІерЅєрІ│ рЅђрѕѕрѕЮ
­ЪЉ«­ЪЈйРђЇРЎѓ	рІѕріЋрІх рЇќрѕірѕх: рѕўрѕЃріерѕѕріЏ рІерЅєрІ│ рЅђрѕѕрѕЮ
­ЪЉ«­ЪЈЙРђЇРЎѓ№ИЈ	рІѕріЋрІх рЇќрѕірѕхрЇА рѕўрѕЃріерѕѕріЏ рЅђрѕІ рІФрѕѕ рІерЅєрІ│ рЅђрѕѕрѕЮ
­ЪЉ«­ЪЈЙРђЇРЎѓ	рІѕріЋрІх рЇќрѕірѕхрЇА рѕўрѕЃріерѕѕріЏ рЅђрѕІ рІФрѕѕ рІерЅєрІ│ рЅђрѕѕрѕЮ
­ЪЉ«­ЪЈ┐РђЇРЎѓ№ИЈ	рІѕріЋрІх рЇќрѕірѕх: рїЦрЅЂрѕГ рІерЅєрІ│ рЅђрѕѕрѕЮ
­ЪЉ«­ЪЈ┐РђЇРЎѓ	рІѕріЋрІх рЇќрѕірѕх: рїЦрЅЂрѕГ рІерЅєрІ│ рЅђрѕѕрѕЮ
­ЪЉ«РђЇРЎђ№ИЈ	рѕ┤рЅх рЇќрѕірѕх
­ЪЉ«РђЇРЎђ	рѕ┤рЅх рЇќрѕірѕх
­ЪЉ«­ЪЈ╗РђЇРЎђ№ИЈ	рѕ┤рЅх рЇќрѕірѕх: рЅђрѕІрѕЇ рІерЅєрІ│ рЅђрѕѕрѕЮ
­ЪЉ«­ЪЈ╗РђЇРЎђ	рѕ┤рЅх рЇќрѕірѕх: рЅђрѕІрѕЇ рІерЅєрІ│ рЅђрѕѕрѕЮ
­ЪЉ«­ЪЈ╝РђЇРЎђ№ИЈ	рѕ┤рЅх рЇќрѕірѕхрЇА рѕўрѕЃріерѕѕріЏ рЅђрѕІ рІФрѕѕ рІерЅєрІ│ рЅђрѕѕрѕЮ
­ЪЉ«­ЪЈ╝РђЇРЎђ	рѕ┤рЅх рЇќрѕірѕхрЇА рѕўрѕЃріерѕѕріЏ рЅђрѕІ рІФрѕѕ рІерЅєрІ│ рЅђрѕѕрѕЮ
­ЪЉ«­ЪЈйРђЇРЎђ№ИЈ	рѕ┤рЅх рЇќрѕірѕх: рѕўрѕЃріерѕѕріЏ рІерЅєрІ│ рЅђрѕѕрѕЮ
­ЪЉ«­ЪЈйРђЇРЎђ	рѕ┤рЅх рЇќрѕірѕх: рѕўрѕЃріерѕѕріЏ рІерЅєрІ│ рЅђрѕѕрѕЮ
­ЪЉ«­ЪЈЙРђЇРЎђ№ИЈ	рѕ┤рЅх рЇќрѕірѕхрЇА рѕўрѕЃріерѕѕріЏ рЅђрѕІ рІФрѕѕ рІерЅєрІ│ рЅђрѕѕрѕЮ
­ЪЉ«­ЪЈЙРђЇРЎђ	рѕ┤рЅх рЇќрѕірѕхрЇА рѕўрѕЃріерѕѕріЏ рЅђрѕІ рІФрѕѕ рІерЅєрІ│ рЅђрѕѕрѕЮ
­ЪЉ«­ЪЈ┐РђЇРЎђ№ИЈ	рѕ┤рЅх рЇќрѕірѕх: рїЦрЅЂрѕГ рІерЅєрІ│ рЅђрѕѕрѕЮ
­ЪЉ«­ЪЈ┐РђЇРЎђ	рѕ┤рЅх рЇќрѕірѕх: рїЦрЅЂрѕГ рІерЅєрІ│ рЅђрѕѕрѕЮ
­ЪЋх№ИЈ	рѕўрѕГрѕЏрѕф
­ЪЋх	рѕўрѕГрѕЏрѕф
­ЪЋх­ЪЈ╗	рѕўрѕГрѕЏрѕф: рЅђрѕІрѕЇ рІерЅєрІ│ рЅђрѕѕрѕЮ
­ЪЋх­ЪЈ╝	рѕўрѕГрѕЏрѕфрЇА рѕўрѕЃріерѕѕріЏ рЅђрѕІ рІФрѕѕ рІерЅєрІ│ рЅђрѕѕрѕЮ
­ЪЋх­ЪЈй	рѕўрѕГрѕЏрѕф: рѕўрѕЃріерѕѕріЏ рІерЅєрІ│ рЅђрѕѕрѕЮ
­ЪЋх­ЪЈЙ	рѕўрѕГрѕЏрѕф: рѕўрѕЃріерѕѕріЏ-рїЦрЅЂрѕГ рІерЅєрІ│ рЅђрѕѕрѕЮ
­ЪЋх­ЪЈ┐	рѕўрѕГрѕЏрѕф: рїЦрЅЂрѕГ рІерЅєрІ│ рЅђрѕѕрѕЮ
­ЪЋх№ИЈРђЇРЎѓ№ИЈ	рѕ░рІЇ рѕўрѕГрѕЏрѕф
­ЪЋхРђЇРЎѓ№ИЈ	рѕ░рІЇ рѕўрѕГрѕЏрѕф
­ЪЋх№ИЈРђЇРЎѓ	рѕ░рІЇ рѕўрѕГрѕЏрѕф
­ЪЋхРђЇРЎѓ	рѕ░рІЇ рѕўрѕГрѕЏрѕф
­ЪЋх­ЪЈ╗РђЇРЎѓ№ИЈ	рѕ░рІЇ рѕўрѕГрѕЏрѕф: рЅђрѕІрѕЇ рІерЅєрІ│ рЅђрѕѕрѕЮ
­ЪЋх­ЪЈ╗РђЇРЎѓ	рѕ░рІЇ рѕўрѕГрѕЏрѕф: рЅђрѕІрѕЇ рІерЅєрІ│ рЅђрѕѕрѕЮ
­ЪЋх­ЪЈ╝РђЇРЎѓ№ИЈ	рѕ░рІЇ рѕўрѕГрѕЏрѕф: рѕўрѕЃріерѕѕріЏ рЅђрѕІ рІФрѕѕ рІерЅєрІ│ рЅђрѕѕрѕЮ
­ЪЋх­ЪЈ╝РђЇРЎѓ	рѕ░рІЇ рѕўрѕГрѕЏрѕф: рѕўрѕЃріерѕѕріЏ рЅђрѕІ рІФрѕѕ рІерЅєрІ│ рЅђрѕѕрѕЮ
­ЪЋх­ЪЈйРђЇРЎѓ№ИЈ	рѕ░рІЇ рѕўрѕГрѕЏрѕф: рѕўрѕЃріерѕѕріЏ рІерЅєрІ│ рЅђрѕѕрѕЮ
­ЪЋх­ЪЈйРђЇРЎѓ	рѕ░рІЇ рѕўрѕГрѕЏрѕф: рѕўрѕЃріерѕѕріЏ рІерЅєрІ│ рЅђрѕѕрѕЮ
­ЪЋх­ЪЈЙРђЇРЎѓ№ИЈ	рѕ░рІЇ рѕўрѕГрѕЏрѕф: рѕўрѕЃріерѕѕріЏ-рїЦрЅЂрѕГ рІерЅєрІ│ рЅђрѕѕрѕЮ
­ЪЋх­ЪЈЙРђЇРЎѓ	рѕ░рІЇ рѕўрѕГрѕЏрѕф: рѕўрѕЃріерѕѕріЏ-рїЦрЅЂрѕГ рІерЅєрІ│ рЅђрѕѕрѕЮ
­ЪЋх­ЪЈ┐РђЇРЎѓ№ИЈ	рѕ░рІЇ рѕўрѕГрѕЏрѕф: рїЦрЅЂрѕГ рІерЅєрІ│ рЅђрѕѕрѕЮ
­ЪЋх­ЪЈ┐РђЇРЎѓ	рѕ░рІЇ рѕўрѕГрѕЏрѕф: рїЦрЅЂрѕГ рІерЅєрІ│ рЅђрѕѕрѕЮ
­ЪЋх№ИЈРђЇРЎђ№ИЈ	рѕ┤рЅх рѕўрѕГрѕЏрѕф
­ЪЋхРђЇРЎђ№ИЈ	рѕ┤рЅх рѕўрѕГрѕЏрѕф
­ЪЋх№ИЈРђЇРЎђ	рѕ┤рЅх рѕўрѕГрѕЏрѕф
­ЪЋхРђЇРЎђ	рѕ┤рЅх рѕўрѕГрѕЏрѕф
­ЪЋх­ЪЈ╗РђЇРЎђ№ИЈ	рѕ┤рЅх рѕўрѕГрѕЏрѕф: рЅђрѕІрѕЇ рІерЅєрІ│ рЅђрѕѕрѕЮ
­ЪЋх­ЪЈ╗РђЇРЎђ	рѕ┤рЅх рѕўрѕГрѕЏрѕф: рЅђрѕІрѕЇ рІерЅєрІ│ рЅђрѕѕрѕЮ
­ЪЋх­ЪЈ╝РђЇРЎђ№ИЈ	рѕ┤рЅх рѕўрѕГрѕЏрѕфрЇА рѕўрѕЃріерѕѕріЏ рЅђрѕІ рІФрѕѕ рІерЅєрІ│ рЅђрѕѕрѕЮ
­ЪЋх­ЪЈ╝РђЇРЎђ	рѕ┤рЅх рѕўрѕГрѕЏрѕфрЇА рѕўрѕЃріерѕѕріЏ рЅђрѕІ рІФрѕѕ рІерЅєрІ│ рЅђрѕѕрѕЮ
­ЪЋх­ЪЈйРђЇРЎђ№ИЈ	рѕ┤рЅх рѕўрѕГрѕЏрѕф: рѕўрѕЃріерѕѕріЏ рІерЅєрІ│ рЅђрѕѕрѕЮ
­ЪЋх­ЪЈйРђЇРЎђ	рѕ┤рЅх рѕўрѕГрѕЏрѕф: рѕўрѕЃріерѕѕріЏ рІерЅєрІ│ рЅђрѕѕрѕЮ
­ЪЋх­ЪЈЙРђЇРЎђ№ИЈ	рѕ┤рЅх рѕўрѕГрѕЏрѕфрЇА рѕўрѕЃріерѕѕріЏ рЅђрѕІ рІФрѕѕ рІерЅєрІ│ рЅђрѕѕрѕЮ
­ЪЋх­ЪЈЙРђЇРЎђ	рѕ┤рЅх рѕўрѕГрѕЏрѕфрЇА рѕўрѕЃріерѕѕріЏ рЅђрѕІ рІФрѕѕ рІерЅєрІ│ рЅђрѕѕрѕЮ
­ЪЋх­ЪЈ┐РђЇРЎђ№ИЈ	рѕ┤рЅх рѕўрѕГрѕЏрѕф: рїЦрЅЂрѕГ рІерЅєрІ│ рЅђрѕѕрѕЮ
­ЪЋх­ЪЈ┐РђЇРЎђ	рѕ┤рЅх рѕўрѕГрѕЏрѕф: рїЦрЅЂрѕГ рІерЅєрІ│ рЅђрѕѕрѕЮ
­Ъњѓ	рїарЅБрЅѓ
­Ъњѓ­ЪЈ╗	рїарЅБрЅѓ: рЅђрѕІрѕЇ рІерЅєрІ│ рЅђрѕѕрѕЮ
­Ъњѓ­ЪЈ╝	рїарЅБрЅѓ: рѕўрѕЃріерѕѕріЏ рЅђрѕІ рІФрѕѕ рІерЅєрІ│ рЅђрѕѕрѕЮ
­Ъњѓ­ЪЈй	рїарЅБрЅѓ: рѕўрѕЃріерѕѕріЏ рІерЅєрІ│ рЅђрѕѕрѕЮ
­Ъњѓ­ЪЈЙ	рїарЅБрЅѓ: рѕўрѕЃріерѕѕріЏ-рїЦрЅЂрѕГ рІерЅєрІ│ рЅђрѕѕрѕЮ
­Ъњѓ­ЪЈ┐	рїарЅБрЅѓ: рїЦрЅЂрѕГ рІерЅєрІ│ рЅђрѕѕрѕЮ
­ЪњѓРђЇРЎѓ№ИЈ	рѕ░рІЇ рїарЅБрЅѓ
­ЪњѓРђЇРЎѓ	рѕ░рІЇ рїарЅБрЅѓ
­Ъњѓ­ЪЈ╗РђЇРЎѓ№ИЈ	рѕ░рІЇ рїарЅБрЅѓ: рЅђрѕІрѕЇ рІерЅєрІ│ рЅђрѕѕрѕЮ
­Ъњѓ­ЪЈ╗РђЇРЎѓ	рѕ░рІЇ рїарЅБрЅѓ: рЅђрѕІрѕЇ рІерЅєрІ│ рЅђрѕѕрѕЮ
­Ъњѓ­ЪЈ╝РђЇРЎѓ№ИЈ	рѕ░рІЇ рїарЅБрЅѓ: рѕўрѕЃріерѕѕріЏ рЅђрѕІ рІФрѕѕ рІерЅєрІ│ рЅђрѕѕрѕЮ
­Ъњѓ­ЪЈ╝РђЇРЎѓ	рѕ░рІЇ рїарЅБрЅѓ: рѕўрѕЃріерѕѕріЏ рЅђрѕІ рІФрѕѕ рІерЅєрІ│ рЅђрѕѕрѕЮ
­Ъњѓ­ЪЈйРђЇРЎѓ№ИЈ	рѕ░рІЇ рїарЅБрЅѓ: рѕўрѕЃріерѕѕріЏ рІерЅєрІ│ рЅђрѕѕрѕЮ
­Ъњѓ­ЪЈйРђЇРЎѓ	рѕ░рІЇ рїарЅБрЅѓ: рѕўрѕЃріерѕѕріЏ рІерЅєрІ│ рЅђрѕѕрѕЮ
­Ъњѓ­ЪЈЙРђЇРЎѓ№ИЈ	рѕ░рІЇ рїарЅБрЅѓ: рѕўрѕЃріерѕѕріЏ-рїЦрЅЂрѕГ рІерЅєрІ│ рЅђрѕѕрѕЮ
­Ъњѓ­ЪЈЙРђЇРЎѓ	рѕ░рІЇ рїарЅБрЅѓ: рѕўрѕЃріерѕѕріЏ-рїЦрЅЂрѕГ рІерЅєрІ│ рЅђрѕѕрѕЮ
­Ъњѓ­ЪЈ┐РђЇРЎѓ№ИЈ	рѕ░рІЇ рїарЅБрЅѓ: рїЦрЅЂрѕГ рІерЅєрІ│ рЅђрѕѕрѕЮ
­Ъњѓ­ЪЈ┐РђЇРЎѓ	рѕ░рІЇ рїарЅБрЅѓ: рїЦрЅЂрѕГ рІерЅєрІ│ рЅђрѕѕрѕЮ
­ЪњѓРђЇРЎђ№ИЈ	рѕ┤рЅх рїарЅБрЅѓ
­ЪњѓРђЇРЎђ	рѕ┤рЅх рїарЅБрЅѓ
­Ъњѓ­ЪЈ╗РђЇРЎђ№ИЈ	рѕ┤рЅх рїарЅБрЅѓ: рЅђрѕІрѕЇ рІерЅєрІ│ рЅђрѕѕрѕЮ
­Ъњѓ­ЪЈ╗РђЇРЎђ	рѕ┤рЅх рїарЅБрЅѓ: рЅђрѕІрѕЇ рІерЅєрІ│ рЅђрѕѕрѕЮ
­Ъњѓ­ЪЈ╝РђЇРЎђ№ИЈ	рѕ┤рЅх рїарЅБрЅѓ: рѕўрѕЃріерѕѕріЏ рЅђрѕІ рІФрѕѕ рІерЅєрІ│ рЅђрѕѕрѕЮ
­Ъњѓ­ЪЈ╝РђЇРЎђ	рѕ┤рЅх рїарЅБрЅѓ: рѕўрѕЃріерѕѕріЏ рЅђрѕІ рІФрѕѕ рІерЅєрІ│ рЅђрѕѕрѕЮ
­Ъњѓ­ЪЈйРђЇРЎђ№ИЈ	рѕ┤рЅх рїарЅБрЅѓ: рѕўрѕЃріерѕѕріЏ рІерЅєрІ│ рЅђрѕѕрѕЮ
­Ъњѓ­ЪЈйРђЇРЎђ	рѕ┤рЅх рїарЅБрЅѓ: рѕўрѕЃріерѕѕріЏ рІерЅєрІ│ рЅђрѕѕрѕЮ
­Ъњѓ­ЪЈЙРђЇРЎђ№ИЈ	рѕ┤рЅх рїарЅБрЅѓ: рѕўрѕЃріерѕѕріЏ-рїЦрЅЂрѕГ рІерЅєрІ│ рЅђрѕѕрѕЮ
­Ъњѓ­ЪЈЙРђЇРЎђ	рѕ┤рЅх рїарЅБрЅѓ: рѕўрѕЃріерѕѕріЏ-рїЦрЅЂрѕГ рІерЅєрІ│ рЅђрѕѕрѕЮ
­Ъњѓ­ЪЈ┐РђЇРЎђ№ИЈ	рѕ┤рЅх рїарЅБрЅѓ: рїЦрЅЂрѕГ рІерЅєрІ│ рЅђрѕѕрѕЮ
­Ъњѓ­ЪЈ┐РђЇРЎђ	рѕ┤рЅх рїарЅБрЅѓ: рїЦрЅЂрѕГ рІерЅєрІ│ рЅђрѕѕрѕЮ
­ЪЉи	рІерїЇріЋрЅБрЅ│ рѕ░рѕФрЅ░ріЏ
­ЪЉи­ЪЈ╗	рІерїЇріЋрЅБрЅ│ рѕ░рѕФрЅ░ріЏ: рЅђрѕІрѕЇ рІерЅєрІ│ рЅђрѕѕрѕЮ
­ЪЉи­ЪЈ╝	рІерїЇріЋрЅБрЅ│ рѕ░рѕФрЅ░ріЏ: рѕўрѕЃріерѕѕріЏ рЅђрѕІ рІФрѕѕ рІерЅєрІ│ рЅђрѕѕрѕЮ
­ЪЉи­ЪЈй	рІерїЇріЋрЅБрЅ│ рѕ░рѕФрЅ░ріЏ: рѕўрѕЃріерѕѕріЏ рІерЅєрІ│ рЅђрѕѕрѕЮ
­ЪЉи­ЪЈЙ	рІерїЇріЋрЅБрЅ│ рѕ░рѕФрЅ░ріЏ: рѕўрѕЃріерѕѕріЏ-рїЦрЅЂрѕГ рІерЅєрІ│ рЅђрѕѕрѕЮ
­ЪЉи­ЪЈ┐	рІерїЇріЋрЅБрЅ│ рѕ░рѕФрЅ░ріЏ: рїЦрЅЂрѕГ рІерЅєрІ│ рЅђрѕѕрѕЮ
­ЪЉиРђЇРЎѓ№ИЈ	рѕ░рІЇ рІерїЇріЋрЅБрЅ│ рѕарѕФрЅ░ріЏ
­ЪЉиРђЇРЎѓ	рѕ░рІЇ рІерїЇріЋрЅБрЅ│ рѕарѕФрЅ░ріЏ
­ЪЉи­ЪЈ╗РђЇРЎѓ№ИЈ	рѕ░рІЇ рІерїЇріЋрЅБрЅ│ рѕ░рѕФрЅ░ріЏ: рЅђрѕІрѕЇ рІерЅєрІ│ рЅђрѕѕрѕЮ
­ЪЉи­ЪЈ╗РђЇРЎѓ	рѕ░рІЇ рІерїЇріЋрЅБрЅ│ рѕ░рѕФрЅ░ріЏ: рЅђрѕІрѕЇ рІерЅєрІ│ рЅђрѕѕрѕЮ
­ЪЉи­ЪЈ╝РђЇРЎѓ№ИЈ	рѕ░рІЇ рІерїЇріЋрЅБрЅ│ рѕ░рѕФрЅ░ріЏ: рѕўрѕЃріерѕѕріЏ рЅђрѕІ рІФрѕѕ рІерЅєрІ│ рЅђрѕѕрѕЮ
­ЪЉи­ЪЈ╝РђЇРЎѓ	рѕ░рІЇ рІерїЇріЋрЅБрЅ│ рѕ░рѕФрЅ░ріЏ: рѕўрѕЃріерѕѕріЏ рЅђрѕІ рІФрѕѕ рІерЅєрІ│ рЅђрѕѕрѕЮ
­ЪЉи­ЪЈйРђЇРЎѓ№ИЈ	рѕ░рІЇ рІерїЇріЋрЅБрЅ│ рѕ░рѕФрЅ░ріЏ: рѕўрѕЃріерѕѕріЏ рІерЅєрІ│ рЅђрѕѕрѕЮ
­ЪЉи­ЪЈйРђЇРЎѓ	рѕ░рІЇ рІерїЇріЋрЅБрЅ│ рѕ░рѕФрЅ░ріЏ: рѕўрѕЃріерѕѕріЏ рІерЅєрІ│ рЅђрѕѕрѕЮ
­ЪЉи­ЪЈЙРђЇРЎѓ№ИЈ	рѕ░рІЇ рІерїЇріЋрЅБрЅ│ рѕ░рѕФрЅ░ріЏ: рѕўрѕЃріерѕѕріЏ-рїЦрЅЂрѕГ рІерЅєрІ│ рЅђрѕѕрѕЮ
­ЪЉи­ЪЈЙРђЇРЎѓ	рѕ░рІЇ рІерїЇріЋрЅБрЅ│ рѕ░рѕФрЅ░ріЏ: рѕўрѕЃріерѕѕріЏ-рїЦрЅЂрѕГ рІерЅєрІ│ рЅђрѕѕрѕЮ
­ЪЉи­ЪЈ┐РђЇРЎѓ№ИЈ	рѕ░рІЇ рІерїЇріЋрЅБрЅ│ рѕ░рѕФрЅ░ріЏ: рїЦрЅЂрѕГ рІерЅєрІ│ рЅђрѕѕрѕЮ
­ЪЉи­ЪЈ┐РђЇРЎѓ	рѕ░рІЇ рІерїЇріЋрЅБрЅ│ рѕ░рѕФрЅ░ріЏ: рїЦрЅЂрѕГ рІерЅєрІ│ рЅђрѕѕрѕЮ
­ЪЉиРђЇРЎђ№ИЈ	рѕ┤рЅх рІерїЇріЋрЅБрЅ│ рѕ░рѕФрЅ░ріЏ
­ЪЉиРђЇРЎђ	рѕ┤рЅх рІерїЇріЋрЅБрЅ│ рѕ░рѕФрЅ░ріЏ
­ЪЉи­ЪЈ╗РђЇРЎђ№ИЈ	рѕ┤рЅх рІерїЇріЋрЅБрЅ│ рѕ░рѕФрЅ░ріЏ: рЅђрѕІрѕЇ рІерЅєрІ│ рЅђрѕѕрѕЮ
­ЪЉи­ЪЈ╗РђЇРЎђ	рѕ┤рЅх рІерїЇріЋрЅБрЅ│ рѕ░рѕФрЅ░ріЏ: рЅђрѕІрѕЇ рІерЅєрІ│ рЅђрѕѕрѕЮ
­ЪЉи­ЪЈ╝РђЇРЎђ№ИЈ	рѕ┤рЅх рІерїЇріЋрЅБрЅ│ рѕ░рѕФрЅ░ріЏ: рѕўрѕЃріерѕѕріЏ рЅђрѕІ рІФрѕѕ рІерЅєрІ│ рЅђрѕѕрѕЮ
­ЪЉи­ЪЈ╝РђЇРЎђ	рѕ┤рЅх рІерїЇріЋрЅБрЅ│ рѕ░рѕФрЅ░ріЏ: рѕўрѕЃріерѕѕріЏ рЅђрѕІ рІФрѕѕ рІерЅєрІ│ рЅђрѕѕрѕЮ
­ЪЉи­ЪЈйРђЇРЎђ№ИЈ	рѕ┤рЅх рІерїЇріЋрЅБрЅ│ рѕ░рѕФрЅ░ріЏ: рѕўрѕЃріерѕѕріЏ рІерЅєрІ│ рЅђрѕѕрѕЮ
­ЪЉи­ЪЈйРђЇРЎђ	рѕ┤рЅх рІерїЇріЋрЅБрЅ│ рѕ░рѕФрЅ░ріЏ: рѕўрѕЃріерѕѕріЏ рІерЅєрІ│ рЅђрѕѕрѕЮ
­ЪЉи­ЪЈЙРђЇРЎђ№ИЈ	рѕ┤рЅх рІерїЇріЋрЅБрЅ│ рѕ░рѕФрЅ░ріЏ: рѕўрѕЃріерѕѕріЏ-рїЦрЅЂрѕГ рІерЅєрІ│ рЅђрѕѕрѕЮ
­ЪЉи­ЪЈЙРђЇРЎђ	рѕ┤рЅх рІерїЇріЋрЅБрЅ│ рѕ░рѕФрЅ░ріЏ: рѕўрѕЃріерѕѕріЏ-рїЦрЅЂрѕГ рІерЅєрІ│ рЅђрѕѕрѕЮ
­ЪЉи­ЪЈ┐РђЇРЎђ№ИЈ	рѕ┤рЅх рІерїЇріЋрЅБрЅ│ рѕ░рѕФрЅ░ріЏ: рїЦрЅЂрѕГ рІерЅєрІ│ рЅђрѕѕрѕЮ
­ЪЉи­ЪЈ┐РђЇРЎђ	рѕ┤рЅх рІерїЇріЋрЅБрЅ│ рѕ░рѕФрЅ░ріЏ: рїЦрЅЂрѕГ рІерЅєрІ│ рЅђрѕѕрѕЮ
­Ъц┤	рѕЇрІЉрѕЇ
­Ъц┤­ЪЈ╗	рѕЇрІЉрѕЇрЇА рЅђрѕІрѕЇ рІерЅєрІ│ рЅђрѕѕрѕЮ
­Ъц┤­ЪЈ╝	рѕЇрІЉрѕЇрЇА рѕўрѕЃріерѕѕріЏ рЅђрѕІ рІФрѕѕ рІерЅєрІ│ рЅђрѕѕрѕЮ
­Ъц┤­ЪЈй	рѕЇрІЉрѕЇрЇА рѕўрѕЃріерѕѕріЏ рІерЅєрІ│ рЅђрѕѕрѕЮ
­Ъц┤­ЪЈЙ	рѕЇрІЉрѕЇ: рѕўрѕЃріерѕѕріЏ-рїЦрЅЂрѕГ рІерЅєрІ│ рЅђрѕѕрѕЮ
­Ъц┤­ЪЈ┐	рѕЇрІЉрѕЇ: рїЦрЅЂрѕГ рІерЅєрІ│ рЅђрѕѕрѕЮ
­ЪЉИ	рѕЇрІЋрѕЇрЅх
­ЪЉИ­ЪЈ╗	рѕЇрІЋрѕЇрЅх: рЅђрѕІрѕЇ рІерЅєрІ│ рЅђрѕѕрѕЮ
­ЪЉИ­ЪЈ╝	рѕЇрІЋрѕЇрЅхрЇА рѕўрѕЃріерѕѕріЏ рЅђрѕІ рІФрѕѕ рІерЅєрІ│ рЅђрѕѕрѕЮ
­ЪЉИ­ЪЈй	рѕЇрІЋрѕЇрЅх: рѕўрѕЃріерѕѕріЏ рІерЅєрІ│ рЅђрѕѕрѕЮ
­ЪЉИ­ЪЈЙ	рѕЇрІЋрѕЇрЅх: рѕўрѕЃріерѕѕріЏ-рїЦрЅЂрѕГ рІерЅєрІ│ рЅђрѕѕрѕЮ
­ЪЉИ­ЪЈ┐	рѕЇрІЋрѕЇрЅх: рїЦрЅЂрѕГ рІерЅєрІ│ рЅђрѕѕрѕЮ
­ЪЉ│	рїЦрѕЮрїБрѕЮ рІерѕѕрЅарѕ░ рѕ░рІЇ
­ЪЉ│­ЪЈ╗	рїЦрѕЮрїБрѕЮ рІерѕѕрЅарѕ░ рѕ░рІЇрЇА рЅђрѕІрѕЇ рІерЅєрІ│ рЅђрѕѕрѕЮ
­ЪЉ│­ЪЈ╝	рїЦрѕЮрїБрѕЮ рІерѕѕрЅарѕ░ рѕ░рІЇрЇА рѕўрѕЃріерѕѕріЏ рЅђрѕІ рІФрѕѕ рІерЅєрІ│ рЅђрѕѕрѕЮ
­ЪЉ│­ЪЈй	рїЦрѕЮрїБрѕЮ рІерѕѕрЅарѕ░ рѕ░рІЇрЇА рѕўрѕЃріерѕѕріЏ рІерЅєрІ│ рЅђрѕѕрѕЮ
­ЪЉ│­ЪЈЙ	рїЦрѕЮрїБрѕЮ рІерѕѕрЅарѕ░ рѕ░рІЇрЇА рѕўрѕЃріерѕѕріЏ рЅђрѕІ рІФрѕѕ рІерЅєрІ│ рЅђрѕѕрѕЮ
­ЪЉ│­ЪЈ┐	рїЦрѕЮрїБрѕЮ рІерѕѕрЅарѕ░ рѕ░рІЇрЇА рїЦрЅЂрѕГ рІерЅєрІ│ рЅђрѕѕрѕЮ
­ЪЉ│РђЇРЎѓ№ИЈ	рїЦрѕЮрїБрѕЮ рІерѕѕрЅарѕ░ рѕ░рІЇ
­ЪЉ│РђЇРЎѓ	рїЦрѕЮрїБрѕЮ рІерѕѕрЅарѕ░ рѕ░рІЇ
­ЪЉ│­ЪЈ╗РђЇРЎѓ№ИЈ	рїЦрѕЮрїБрѕЮ рІерѕѕрЅарѕ░ рѕ░рІЇрЇА рЅђрѕІрѕЇ рІерЅєрІ│ рЅђрѕѕрѕЮ
­ЪЉ│­ЪЈ╗РђЇРЎѓ	рїЦрѕЮрїБрѕЮ рІерѕѕрЅарѕ░ рѕ░рІЇрЇА рЅђрѕІрѕЇ рІерЅєрІ│ рЅђрѕѕрѕЮ
­ЪЉ│­ЪЈ╝РђЇРЎѓ№ИЈ	рїЦрѕЮрїЦрѕЮ рІерѕѕрЅарѕ░ рѕ░рІЇрЇА рѕўрѕЃріерѕѕріЏ рЅђрѕІ рІФрѕѕ рІерЅєрІ│ рЅђрѕѕрѕЮ
­ЪЉ│­ЪЈ╝РђЇРЎѓ	рїЦрѕЮрїЦрѕЮ рІерѕѕрЅарѕ░ рѕ░рІЇрЇА рѕўрѕЃріерѕѕріЏ рЅђрѕІ рІФрѕѕ рІерЅєрІ│ рЅђрѕѕрѕЮ
­ЪЉ│­ЪЈйРђЇРЎѓ№ИЈ	рїЦрѕЮрїБрѕЮ рІерѕѕрЅарѕ░ рѕ░рІЇрЇА рѕўрѕЃріерѕѕріЏ рІерЅєрІ│ рЅђрѕѕрѕЮ
­ЪЉ│­ЪЈйРђЇРЎѓ	рїЦрѕЮрїБрѕЮ рІерѕѕрЅарѕ░ рѕ░рІЇрЇА рѕўрѕЃріерѕѕріЏ рІерЅєрІ│ рЅђрѕѕрѕЮ
­ЪЉ│­ЪЈЙРђЇРЎѓ№ИЈ	рїЦрѕЮрїБрѕЮ рІерѕѕрЅарѕ░ рѕ░рІЇрЇА рѕўрѕЃріерѕѕріЏ рЅђрѕІ рІФрѕѕ рІерЅєрІ│ рЅђрѕѕрѕЮ
­ЪЉ│­ЪЈЙРђЇРЎѓ	рїЦрѕЮрїБрѕЮ рІерѕѕрЅарѕ░ рѕ░рІЇрЇА рѕўрѕЃріерѕѕріЏ рЅђрѕІ рІФрѕѕ рІерЅєрІ│ рЅђрѕѕрѕЮ
­ЪЉ│­ЪЈ┐РђЇРЎѓ№ИЈ	рїЦрѕЮрїБрѕЮ рІерѕѕрЅарѕ░ рѕ░рІЇ: рїЦрЅЂрѕГ рІерЅєрІ│ рЅђрѕѕрѕЮ
­ЪЉ│­ЪЈ┐РђЇРЎѓ	рїЦрѕЮрїБрѕЮ рІерѕѕрЅарѕ░ рѕ░рІЇ: рїЦрЅЂрѕГ рІерЅєрІ│ рЅђрѕѕрѕЮ
­ЪЉ│РђЇРЎђ№ИЈ	рїЦрѕЮрїЦрѕЮ рІерѕѕрЅарѕ░рЅй рѕ┤рЅх
­ЪЉ│РђЇРЎђ	рїЦрѕЮрїЦрѕЮ рІерѕѕрЅарѕ░рЅй рѕ┤рЅх
­ЪЉ│­ЪЈ╗РђЇРЎђ№ИЈ	рїЦрѕЮрїЦрѕЮ рІерѕѕрЅарѕ░рЅй рѕ┤рЅхрЇА рЅђрѕІрѕЇ рІерЅєрІ│ рЅђрѕѕрѕЮ
­ЪЉ│­ЪЈ╗РђЇРЎђ	рїЦрѕЮрїЦрѕЮ рІерѕѕрЅарѕ░рЅй рѕ┤рЅхрЇА рЅђрѕІрѕЇ рІерЅєрІ│ рЅђрѕѕрѕЮ
­ЪЉ│­ЪЈ╝РђЇРЎђ№ИЈ	рїЦрѕЮрїЦрѕЮ рІерѕѕрЅарѕ░рЅй рѕ┤рЅхрЇА рѕўрѕЃріерѕѕріЏ рЅђрѕІ рІФрѕѕ рІерЅєрІ│ рЅђрѕѕрѕЮ
­ЪЉ│­ЪЈ╝РђЇРЎђ	рїЦрѕЮрїЦрѕЮ рІерѕѕрЅарѕ░рЅй рѕ┤рЅхрЇА рѕўрѕЃріерѕѕріЏ рЅђрѕІ рІФрѕѕ рІерЅєрІ│ рЅђрѕѕрѕЮ
­ЪЉ│­ЪЈйРђЇРЎђ№ИЈ	рїЦрѕЮрїЦрѕЮ рІерѕѕрЅарѕ░рЅй рѕ┤рЅхрЇА рѕўрѕЃріерѕѕріЏ рІерЅєрІ│ рЅђрѕѕрѕЮ
­ЪЉ│­ЪЈйРђЇРЎђ	рїЦрѕЮрїЦрѕЮ рІерѕѕрЅарѕ░рЅй рѕ┤рЅхрЇА рѕўрѕЃріерѕѕріЏ рІерЅєрІ│ рЅђрѕѕрѕЮ
­ЪЉ│­ЪЈЙРђЇРЎђ№ИЈ	рїЦрѕЮрїЦрѕЮ рІерѕѕрЅарѕ░рЅй рѕ┤рЅхрЇА рѕўрѕЃріерѕѕріЏ рЅђрѕІ рІФрѕѕ рІерЅєрІ│ рЅђрѕѕрѕЮ
­ЪЉ│­ЪЈЙРђЇРЎђ	рїЦрѕЮрїЦрѕЮ рІерѕѕрЅарѕ░рЅй рѕ┤рЅхрЇА рѕўрѕЃріерѕѕріЏ рЅђрѕІ рІФрѕѕ рІерЅєрІ│ рЅђрѕѕрѕЮ
­ЪЉ│­ЪЈ┐РђЇРЎђ№ИЈ	рїЦрѕЮрїЦрѕЮ рІерѕѕрЅарѕ░рЅй рѕ┤рЅхрЇА рїЦрЅЂрѕГ рІерЅєрІ│ рЅђрѕѕрѕЮ
­ЪЉ│­ЪЈ┐РђЇРЎђ	рїЦрѕЮрїЦрѕЮ рІерѕѕрЅарѕ░рЅй рѕ┤рЅхрЇА рїЦрЅЂрѕГ рІерЅєрІ│ рЅђрѕѕрѕЮ
­ЪЉ▓	рІерЅ╗рІГріЊ ріФрЇЋ рІФрѕѕрІЇ рѕ░рІЇ
­ЪЉ▓­ЪЈ╗	рІерЅ╗рІГріЊ рЅєрЅЦ рІФрѕѕрІЇ рѕ░рІЇрЇА рЅђрѕІрѕЇ рІерЅєрІ│ рЅђрѕѕрѕЮ
­ЪЉ▓­ЪЈ╝	рІерЅ╗рІГріЊ рЅєрЅЦ рІФрѕѕрІЇ рѕ░рІЇрЇА рѕўрѕЃріерѕѕріЏ рЅђрѕІ рІФрѕѕ рІерЅєрІ│ рЅђрѕѕрѕЮ
­ЪЉ▓­ЪЈй	рІерЅ╗рІГріЊ рЅєрЅЦ рІФрѕѕрІЇ рѕ░рІЇ: рѕўрѕЃріерѕѕріЏ рІерЅєрІ│ рЅђрѕѕрѕЮ
­ЪЉ▓­ЪЈЙ	рІерЅ╗рІГріЊ рЅєрЅЦ рІФрѕѕрІЇ рѕ░рІЇрЇА рѕўрѕЃріерѕѕріЏ рЅђрѕІ рІФрѕѕ рІерЅєрІ│ рЅђрѕѕрѕЮ
­ЪЉ▓­ЪЈ┐	рІерЅ╗рІГріЊ рЅєрЅЦ рІФрѕѕрІЇ рѕ░рІЇ: рїЦрЅЂрѕГ рІерЅєрІ│ рЅђрѕѕрѕЮ
­ЪДЋ	рІерѕФрѕх рѕўрѕИрЇѕріЏ рІФрѕІрЅх рѕ┤рЅх
­ЪДЋ­ЪЈ╗	рІерѕФрѕх рѕўрѕИрЇѕріЏ рІФрѕІрЅх рѕ┤рЅхрЇА рЅђрѕІрѕЇ рІерЅєрІ│ рЅђрѕѕрѕЮ
­ЪДЋ­ЪЈ╝	рІерѕФрѕх рѕўрѕИрЇѕріЏ рІФрѕІрЅх рѕ┤рЅхрЇА рѕўрѕЃріерѕѕріЏ рЅђрѕІ рІФрѕѕ рІерЅєрІ│ рЅђрѕѕрѕЮ
­ЪДЋ­ЪЈй	рІерѕФрѕх рѕўрѕИрЇѕріЏ рІФрѕІрЅх рѕ┤рЅхрЇА рѕўрѕЃріерѕѕріЏ рІерЅєрІ│ рЅђрѕѕрѕЮ
­ЪДЋ­ЪЈЙ	рІерѕФрѕх рѕўрѕИрЇѕріЏ рІФрѕІрЅх рѕ┤рЅхрЇА рѕўрѕЃріерѕѕріЏ рЅђрѕІ рІФрѕѕ рІерЅєрІ│ рЅђрѕѕрѕЮ
­ЪДЋ­ЪЈ┐	рІерѕФрѕх рѕўрѕИрЇѕріЏ рІФрѕІрЅх рѕ┤рЅх: рїЦрЅЂрѕГ рІерЅєрІ│ рЅђрѕѕрѕЮ
­ЪДћ	рїбрѕЮ рІФрѕѕрІЇ рѕ░рІЇ
­ЪДћ­ЪЈ╗	рїбрѕЮ рІФрѕѕрІЇ рѕ░рІЇрЇА рЅђрѕІрѕЇ рІерЅєрІ│ рЅђрѕѕрѕЮ
­ЪДћ­ЪЈ╝	рїбрѕЮ рІФрѕѕрІЇ рѕ░рІЇрЇА рѕўрѕЃріерѕѕріЏ рЅђрѕІ рІФрѕѕ рІерЅєрІ│ рЅђрѕѕрѕЮ
­ЪДћ­ЪЈй	рїбрѕЮ рІФрѕѕрІЇ рѕ░рІЇрЇА рѕўрѕЃріерѕѕріЏ рІерЅєрІ│ рЅђрѕѕрѕЮ
­ЪДћ­ЪЈЙ	рїбрѕЮ рІФрѕѕрІЇ рѕ░рІЇрЇА рѕўрѕЃріерѕѕріЏ рЅђрѕІ рІФрѕѕ рІерЅєрІ│ рЅђрѕѕрѕЮ
­ЪДћ­ЪЈ┐	рїбрѕЮ рІФрѕѕрІЇ рѕ░рІЇ: рїЦрЅЂрѕГ рІерЅєрІ│ рЅђрѕѕрѕЮ
­ЪЉ▒	рїИрїЅрѕГ рІФрѕѕрІЇ рЇђрїЅрѕГ рІФрѕѕрІЇ рѕ░рІЇ
­ЪЉ▒­ЪЈ╗	рЇђрїЅрѕГрѕй рЇђрїЅрѕГ рІФрѕѕрІЇ рѕ░рІЇрЇА рЅђрѕІрѕЇ рІерЅєрІ│ рЅђрѕѕрѕЮ
­ЪЉ▒­ЪЈ╝	рЇђрїЅрѕГрѕй рЇђрїЅрѕГ рІФрѕѕрІЇ рѕ░рІЇрЇА рѕўрѕЃріерѕѕріЏ рЅђрѕІ рІФрѕѕ рІерЅєрІ│ рЅђрѕѕрѕЮ
­ЪЉ▒­ЪЈй	рЇђрїЅрѕГрѕй рЇђрїЅрѕГ рІФрѕѕрІЇ рѕ░рІЇрЇА рѕўрѕЃріерѕѕріЏ рІерЅєрІ│ рЅђрѕѕрѕЮ
­ЪЉ▒­ЪЈЙ	рЇђрїЅрѕГрѕй рЇђрїЅрѕГ рІФрѕѕрІЇ рѕ░рІЇрЇА рѕўрѕЃріерѕѕріЏ рЅђрѕІ рІФрѕѕ рІерЅєрІ│ рЅђрѕѕрѕЮ
­ЪЉ▒­ЪЈ┐	рЇђрїЅрѕГрѕй рЇђрїЅрѕГ рІФрѕѕрІЇ рѕ░рІЇрЇА рїЦрЅЂрѕГ рІерЅєрІ│ рЅђрѕѕрѕЮ
­ЪЉ▒РђЇРЎѓ№ИЈ	рЇђрїЅрѕГрѕЏ рЇђрїЅрѕГ рІФрѕѕрІЇ рѕ░рІЇ
­ЪЉ▒РђЇРЎѓ	рЇђрїЅрѕГрѕЏ рЇђрїЅрѕГ рІФрѕѕрІЇ рѕ░рІЇ
­ЪЉ▒­ЪЈ╗РђЇРЎѓ№ИЈ	рЇђрїЅрѕГрѕй рЇђрїЅрѕГ рІФрѕѕрІЇ рѕ░рІЇрЇА рЅђрѕІрѕЇ рІерЅєрІ│ рЅђрѕѕрѕЮ
­ЪЉ▒­ЪЈ╗РђЇРЎѓ	рЇђрїЅрѕГрѕй рЇђрїЅрѕГ рІФрѕѕрІЇ рѕ░рІЇрЇА рЅђрѕІрѕЇ рІерЅєрІ│ рЅђрѕѕрѕЮ
­ЪЉ▒­ЪЈ╝РђЇРЎѓ№ИЈ	рЇђрїЅрѕГрѕй рЇђрїЅрѕГ рІФрѕѕрІЇ рѕ░рІЇрЇА рѕўрѕЃріерѕѕріЏ рЅђрѕІ рІФрѕѕ рІерЅєрІ│ рЅђрѕѕрѕЮ
­ЪЉ▒­ЪЈ╝РђЇРЎѓ	рЇђрїЅрѕГрѕй рЇђрїЅрѕГ рІФрѕѕрІЇ рѕ░рІЇрЇА рѕўрѕЃріерѕѕріЏ рЅђрѕІ рІФрѕѕ рІерЅєрІ│ рЅђрѕѕрѕЮ
­ЪЉ▒­ЪЈйРђЇРЎѓ№ИЈ	рЇђрїЅрѕГрѕй рЇђрїЅрѕГ рІФрѕѕрІЇ рѕ░рІЇрЇА рѕўрѕЃріерѕѕріЏ рІерЅєрІ│ рЅђрѕѕрѕЮ
­ЪЉ▒­ЪЈйРђЇРЎѓ	рЇђрїЅрѕГрѕй рЇђрїЅрѕГ рІФрѕѕрІЇ рѕ░рІЇрЇА рѕўрѕЃріерѕѕріЏ рІерЅєрІ│ рЅђрѕѕрѕЮ
­ЪЉ▒­ЪЈЙРђЇРЎѓ№ИЈ	рЇђрїЅрѕГрѕй рЇђрїЅрѕГ рІФрѕѕрІЇ рѕ░рІЇрЇА рѕўрѕЃріерѕѕріЏ рЅђрѕІ рІФрѕѕ рІерЅєрІ│ рЅђрѕѕрѕЮ
­ЪЉ▒­ЪЈЙРђЇРЎѓ	рЇђрїЅрѕГрѕй рЇђрїЅрѕГ рІФрѕѕрІЇ рѕ░рІЇрЇА рѕўрѕЃріерѕѕріЏ рЅђрѕІ рІФрѕѕ рІерЅєрІ│ рЅђрѕѕрѕЮ
­ЪЉ▒­ЪЈ┐РђЇРЎѓ№ИЈ	рЇђрїЅрѕГрѕй рЇђрїЅрѕГ рІФрѕѕрІЇ рѕ░рІЇрЇА рїЦрЅЂрѕГ рІерЅєрІ│ рЅђрѕѕрѕЮ
­ЪЉ▒­ЪЈ┐РђЇРЎѓ	рЇђрїЅрѕГрѕй рЇђрїЅрѕГ рІФрѕѕрІЇ рѕ░рІЇрЇА рїЦрЅЂрѕГ рІерЅєрІ│ рЅђрѕѕрѕЮ
­ЪЉ▒РђЇРЎђ№ИЈ	рЅБрѕѕрЇђрїЅрѕГ рѕ┤рЅх
­ЪЉ▒РђЇРЎђ	рЅБрѕѕрЇђрїЅрѕГ рѕ┤рЅх
­ЪЉ▒­ЪЈ╗РђЇРЎђ№ИЈ	рЇђрїЅрѕГрѕй рЇђрїЅрѕГрѕй рѕ┤рЅхрЇА рЅђрѕІрѕЇ рІерЅєрІ│ рЅђрѕѕрѕЮ
­ЪЉ▒­ЪЈ╗РђЇРЎђ	рЇђрїЅрѕГрѕй рЇђрїЅрѕГрѕй рѕ┤рЅхрЇА рЅђрѕІрѕЇ рІерЅєрІ│ рЅђрѕѕрѕЮ
­ЪЉ▒­ЪЈ╝РђЇРЎђ№ИЈ	рЇђрїЅрѕГрѕй рЇђрїЅрѕГрѕй рѕ┤рЅхрЇА рѕўрѕЃріерѕѕріЏ рЅђрѕІ рІФрѕѕ рІерЅєрІ│ рЅђрѕѕрѕЮ
­ЪЉ▒­ЪЈ╝РђЇРЎђ	рЇђрїЅрѕГрѕй рЇђрїЅрѕГрѕй рѕ┤рЅхрЇА рѕўрѕЃріерѕѕріЏ рЅђрѕІ рІФрѕѕ рІерЅєрІ│ рЅђрѕѕрѕЮ
­ЪЉ▒­ЪЈйРђЇРЎђ№ИЈ	рЇђрїЅрѕГрѕй рЇђрїЅрѕГрѕй рѕ┤рЅхрЇА рѕўрѕЃріерѕѕріЏ рІерЅєрІ│ рЅђрѕѕрѕЮ
­ЪЉ▒­ЪЈйРђЇРЎђ	рЇђрїЅрѕГрѕй рЇђрїЅрѕГрѕй рѕ┤рЅхрЇА рѕўрѕЃріерѕѕріЏ рІерЅєрІ│ рЅђрѕѕрѕЮ
­ЪЉ▒­ЪЈЙРђЇРЎђ№ИЈ	рЇђрїЅрѕГрѕй рЇђрїЅрѕГрѕй рѕ┤рЅхрЇА рѕўрѕЃріерѕѕріЏ рЅђрѕІ рІФрѕѕ рІерЅєрІ│ рЅђрѕѕрѕЮ
­ЪЉ▒­ЪЈЙРђЇРЎђ	рЇђрїЅрѕГрѕй рЇђрїЅрѕГрѕй рѕ┤рЅхрЇА рѕўрѕЃріерѕѕріЏ рЅђрѕІ рІФрѕѕ рІерЅєрІ│ рЅђрѕѕрѕЮ
­ЪЉ▒­ЪЈ┐РђЇРЎђ№ИЈ	рЇђрїЅрѕГрѕй рЇђрїЅрѕГрѕй рѕ┤рЅхрЇА рїЦрЅЂрѕГ рІерЅєрІ│ рЅђрѕѕрѕЮ
­ЪЉ▒­ЪЈ┐РђЇРЎђ	рЇђрїЅрѕГрѕй рЇђрїЅрѕГрѕй рѕ┤рЅхрЇА рїЦрЅЂрѕГ рІерЅєрІ│ рЅђрѕѕрѕЮ
­ЪЉеРђЇ­Ъд░	рѕ░рІЇ, рЅђрІГ рЇђрїЅрѕГ
­ЪЉе­ЪЈ╗РђЇ­Ъд░	рѕ░рІЇрЇБ рЅђрІГ рЇђрїЅрѕГ рІФрѕѕрІЇрЇА рЅђрѕІрѕЇ рІерЅєрІ│ рЅђрѕѕрѕЮ
­ЪЉе­ЪЈ╝РђЇ­Ъд░	рѕ░рІЇрЇБ рЅђрІГ рЇђрїЅрѕГ рІФрѕѕрІЇрЇА рѕўрѕЃріерѕѕріЏ рЅђрѕІ рІФрѕѕ рІерЅєрІ│ рЅђрѕѕрѕЮ
­ЪЉе­ЪЈйРђЇ­Ъд░	рѕ░рІЇрЇБ рЅђрІГ рЇђрїЅрѕГ рІФрѕѕрІЇрЇА рѕўрѕЃріерѕѕріЏ рІерЅєрІ│ рЅђрѕѕрѕЮ
­ЪЉе­ЪЈЙРђЇ­Ъд░	рѕ░рІЇрЇБ рЅђрІГ рЇђрїЅрѕГ рІФрѕѕрІЇрЇА рѕўрѕЃріерѕѕріЏ рЅђрѕІ рІФрѕѕ рІерЅєрІ│ рЅђрѕѕрѕЮ
­ЪЉе­ЪЈ┐РђЇ­Ъд░	рѕ░рІЇрЇБ рЅђрІГ рЇђрїЅрѕГ рІФрѕѕрІЇрЇА рїЦрЅЂрѕГ рІерЅєрІ│ рЅђрѕѕрѕЮ
­ЪЉЕРђЇ­Ъд░	рѕ┤рЅх, рЅђрІГ рЇђрїЅрѕГ
­ЪЉЕ­ЪЈ╗РђЇ­Ъд░	рѕ┤рЅхрЇБ рЅђрІГ рЇђрїЅрѕ»рЇА рЅђрѕІрѕЇ рІерЅєрІ│ рЅђрѕѕрѕЮ
­ЪЉЕ­ЪЈ╝РђЇ­Ъд░	рѕ┤рЅхрЇБ рЅђрІГ рЇђрїЅрѕГ рІФрѕѕрІЇрЇА рѕўрѕЃріерѕѕріЏ рЅђрѕІ рІФрѕѕ рІерЅєрІ│ рЅђрѕѕрѕЮ
­ЪЉЕ­ЪЈйРђЇ­Ъд░	рѕ┤рЅхрЇБ рЅђрІГ рЇђрїЅрѕ»рЇА рѕўрѕЃріерѕѕріЏ рІерЅєрІ│ рЅђрѕѕрѕЮ
­ЪЉЕ­ЪЈЙРђЇ­Ъд░	рѕ┤рЅхрЇБ рЅђрІГ рЇђрїЅрѕ»рЇА рѕўрѕЃріерѕѕріЏ рЅђрѕІ рІФрѕѕ рІерЅєрІ│ рЅђрѕѕрѕЮ
­ЪЉЕ­ЪЈ┐РђЇ­Ъд░	рѕ┤рЅхрЇБ рЅђрІГ рЇђрїЅрѕ»рЇА рїЦрЅЂрѕГ рІерЅєрІ│ рЅђрѕѕрѕЮ
­ЪЉеРђЇ­Ъд▒	рѕ░рІЇ рЇБ рЇђрїЅрѕГрѕй
­ЪЉе­ЪЈ╗РђЇ­Ъд▒	рѕ░рІЇрЇБ рЅБрѕѕрЇђрїЅрѕФрѕЏ рЇђрїЅрѕГрЇА рЅђрѕІрѕЇ рІерЅєрІ│ рЅђрѕѕрѕЮ
­ЪЉе­ЪЈ╝РђЇ­Ъд▒	рѕ░рІЇрЇБ рЅБрѕѕрЇђрїЅрѕГ: рѕўрѕЃріерѕѕріЏ рЅђрѕІ рІФрѕѕ рІерЅєрІ│ рЅђрѕѕрѕЮ
­ЪЉе­ЪЈйРђЇ­Ъд▒	рѕ░рІЇрЇБ рЇђрїЅрѕФрѕЏ рЇђрїЅрѕГ рІФрѕѕрІЇрЇА рѕўрѕЃріерѕѕріЏ рІерЅєрІ│ рЅђрѕѕрѕЮ
­ЪЉе­ЪЈЙРђЇ­Ъд▒	рѕ░рІЇрЇБ рЇђрїЅрѕГрѕй рІерЅ░рїарѕўрїарѕўрЇА рѕўрѕЃріерѕѕріЏ рЅђрѕІ рІФрѕѕ рІерЅєрІ│ рЅђрѕѕрѕЮ
­ЪЉе­ЪЈ┐РђЇ­Ъд▒	рѕ░рІЇрЇБ рЇђрїЅрѕГрѕй рІерЅ░рїарѕўрїарѕўрЇА рїЦрЅЂрѕГ рІерЅєрІ│ рЅђрѕѕрѕЮ
­ЪЉЕРђЇ­Ъд▒	рѕ┤рЅх рЇБ рЇђрїЅрѕГрѕй
­ЪЉЕ­ЪЈ╗РђЇ­Ъд▒	рѕ┤рЅхрЇБ рЇђрїЅрѕГрѕй рЇђрїЅрѕГрѕйрЇА рЅђрѕІрѕЇ рІерЅєрІ│ рЅђрѕѕрѕЮ
­ЪЉЕ­ЪЈ╝РђЇ­Ъд▒	рѕ┤рЅхрЇБ рЇђрїЅрѕФрѕЏ рЇђрїЅрѕГрЇА рѕўрѕЃріерѕѕріЏ рЅђрѕІ рІФрѕѕ рІерЅєрІ│ рЅђрѕѕрѕЮ
­ЪЉЕ­ЪЈйРђЇ­Ъд▒	рѕ┤рЅхрЇБ рЇђрїЅрѕФрѕЏ рЇђрїЅрѕГрЇА рѕўрѕЃріерѕѕріЏ рІерЅєрІ│ рЅђрѕѕрѕЮ
­ЪЉЕ­ЪЈЙРђЇ­Ъд▒	рѕ┤рЅхрЇБ рЇђрїЅрѕФрѕЏ рЇђрїЅрѕГрЇА рѕўрѕЃріерѕѕріЏ рЅђрѕІ рІФрѕѕ рІерЅєрІ│ рЅђрѕѕрѕЮ
­ЪЉЕ­ЪЈ┐РђЇ­Ъд▒	рѕ┤рЅхрЇБ рЇђрїЅрѕФрѕЏ рЇђрїЅрѕГрЇА рїЦрЅЂрѕГ рІерЅєрІ│ рЅђрѕѕрѕЮ
­ЪЉеРђЇ­Ъд▓	рѕ░рІЇ рЇБ рѕўрѕІрїБ
­ЪЉе­ЪЈ╗РђЇ­Ъд▓	рѕ░рІЇрЇБ рѕФрѕ░ рЅарѕФрЇА рЅђрѕІрѕЇ рІерЅєрІ│ рЅђрѕѕрѕЮ
­ЪЉе­ЪЈ╝РђЇ­Ъд▓	рѕ░рІЇрЇБ рѕФрѕ░ рЅарѕФрЇА рѕўрѕЃріерѕѕріЏ рЅђрѕІ рІФрѕѕ рІерЅєрІ│ рЅђрѕѕрѕЮ
­ЪЉе­ЪЈйРђЇ­Ъд▓	рѕ░рІЇрЇБ рѕФрѕ░ рЅарѕФрЇА рѕўрѕЃріерѕѕріЏ рІерЅєрІ│ рЅђрѕѕрѕЮ
­ЪЉе­ЪЈЙРђЇ­Ъд▓	рѕ░рІЇрЇБ рѕФрѕ░ рЅарѕФрЇА рѕўрѕЃріерѕѕріЏ рЅђрѕІ рІФрѕѕ рІерЅєрІ│ рЅђрѕѕрѕЮ
­ЪЉе­ЪЈ┐РђЇ­Ъд▓	рѕ░рІЇ, рѕФрѕ░ рЅарѕФ: рїЦрЅЂрѕГ рІерЅєрІ│ рЅђрѕѕрѕЮ
­ЪЉЕРђЇ­Ъд▓	рѕ┤рЅх рЇБ рѕўрѕІрїБ
­ЪЉЕ­ЪЈ╗РђЇ­Ъд▓	рѕ┤рЅхрЇБ рѕФрѕ░ рЅарѕФрЇА рЅђрѕІрѕЇ рІерЅєрІ│ рЅђрѕѕрѕЮ
­ЪЉЕ­ЪЈ╝РђЇ­Ъд▓	рѕ┤рЅхрЇБ рѕФрѕ░ рЅарѕФрЇА рѕўрѕЃріерѕѕріЏ рЅђрѕІ рІФрѕѕ рІерЅєрІ│ рЅђрѕѕрѕЮ
­ЪЉЕ­ЪЈйРђЇ­Ъд▓	рѕ┤рЅхрЇБ рѕФрѕ░ рЅарѕФрЇА рѕўрѕЃріерѕѕріЏ рІерЅєрІ│ рЅђрѕѕрѕЮ
­ЪЉЕ­ЪЈЙРђЇ­Ъд▓	рѕ┤рЅхрЇБ рѕФрѕ░ рЅарѕФрЇА рѕўрѕЃріерѕѕріЏ рЅђрѕІ рІФрѕѕ рІерЅєрІ│ рЅђрѕѕрѕЮ
­ЪЉЕ­ЪЈ┐РђЇ­Ъд▓	рѕ┤рЅх, рѕФрѕ░ рЅарѕФ: рїЦрЅЂрѕГ рІерЅєрІ│ рЅђрѕѕрѕЮ
­ЪЉеРђЇ­Ъд│	рѕ░рІЇ, ріљрїГ рЇђрїЅрѕГ
­ЪЉе­ЪЈ╗РђЇ­Ъд│	рѕ░рІЇрЇБ ріљрїГ рЇђрїЅрѕГ рІФрѕѕрІЇрЇА рЅђрѕІрѕЇ рІерЅєрІ│ рЅђрѕѕрѕЮ
­ЪЉе­ЪЈ╝РђЇ­Ъд│	рѕ░рІЇрЇБ ріљрїГ рЇђрїЅрѕГ рІФрѕѕрІЇрЇА рѕўрѕЃріерѕѕріЏ рЅђрѕІ рІФрѕѕ рІерЅєрІ│ рЅђрѕѕрѕЮ
­ЪЉе­ЪЈйРђЇ­Ъд│	рѕ░рІЇрЇБ ріљрїГ рЇђрїЅрѕГ рІФрѕѕрІЇрЇА рѕўрѕЃріерѕѕріЏ рІерЅєрІ│ рЅђрѕѕрѕЮ
­ЪЉе­ЪЈЙРђЇ­Ъд│	рѕ░рІЇрЇБ ріљрїГ рЇђрїЅрѕГ рІФрѕѕрІЇрЇА рѕўрѕЃріерѕѕріЏ рЅђрѕІ рІФрѕѕ рІерЅєрІ│ рЅђрѕѕрѕЮ
­ЪЉе­ЪЈ┐РђЇ­Ъд│	рѕ░рІЇ, ріљрїГ рЇђрїЅрѕГ: рїЦрЅЂрѕГ рІерЅєрІ│ рЅђрѕѕрѕЮ
­ЪЉЕРђЇ­Ъд│	рѕ┤рЅх, ріљрїГ рЇђрїЅрѕГ
­ЪЉЕ­ЪЈ╗РђЇ­Ъд│	рѕ┤рЅхрЇБ ріљрїГ рЇђрїЅрѕГ рІФрѕѕрІЇрЇА рЅђрѕІрѕЇ рІерЅєрІ│ рЅђрѕѕрѕЮ
­ЪЉЕ­ЪЈ╝РђЇ­Ъд│	рѕ┤рЅхрЇБ ріљрїГ рЇђрїЅрѕГрЇА рѕўрѕЃріерѕѕріЏ рЅђрѕІ рІФрѕѕ рІерЅєрІ│ рЅђрѕѕрѕЮ
­ЪЉЕ­ЪЈйРђЇ­Ъд│	рѕ┤рЅхрЇБ ріљрїГ рЇђрїЅрѕГ рІФрѕѕрІЇрЇА рѕўрѕЃріерѕѕріЏ рІерЅєрІ│ рЅђрѕѕрѕЮ
­ЪЉЕ­ЪЈЙРђЇ­Ъд│	рѕ┤рЅхрЇБ ріљрїГ рЇђрїЅрѕГрЇА рѕўрѕЃріерѕѕріЏ рЅђрѕІ рІФрѕѕ рІерЅєрІ│ рЅђрѕѕрѕЮ
­ЪЉЕ­ЪЈ┐РђЇ­Ъд│	рѕ┤рЅхрЇБ ріљрїГ рЇђрїЅрѕГ рІФрѕѕрІЇрЇА рїЦрЅЂрѕГ рІерЅєрІ│ рЅђрѕѕрѕЮ
­Ъцх	рѕ░рІЇ рЅа tuxedo
­Ъцх­ЪЈ╗	рѕ░рІЇ рЅа tuxedo: рЅђрѕІрѕЇ рІерЅєрІ│ рЅђрѕѕрѕЮ
­Ъцх­ЪЈ╝	рѕ░рІЇ рЅарЅ▒ріГрѕ░рІХрЇА рѕўрѕЃріерѕѕріЏ рЅђрѕІ рІФрѕѕ рІерЅєрІ│ рЅђрѕѕрѕЮ
­Ъцх­ЪЈй	рѕ░рІЇ рЅа tuxedo: рѕўрѕЃріерѕѕріЏ рІерЅєрІ│ рЅђрѕѕрѕЮ
­Ъцх­ЪЈЙ	рѕ░рІЇ рЅарЅ▒ріГрѕ░рІХрЇА рѕўрѕЃріерѕѕріЏ рЅђрѕІ рІФрѕѕ рІерЅєрІ│ рЅђрѕѕрѕЮ
­Ъцх­ЪЈ┐	рѕ░рІЇ рЅа tuxedo: рїЦрЅЂрѕГ рІерЅєрІ│ рЅђрѕѕрѕЮ
­ЪЉ░	рѕўрѕИрЇѕріЏ рІФрѕІрЅх рѕЎрѕйрѕФ
­ЪЉ░­ЪЈ╗	рѕЎрѕйрѕфрЅх рѕўрїІрѕерїЃ рІФрѕІрЅх: рЅђрѕІрѕЇ рІерЅєрІ│ рЅђрѕѕрѕЮ
­ЪЉ░­ЪЈ╝	рѕЎрѕйрѕфрЅх ріерѕўрїІрѕерїЃ рїІрѕГрЇА рѕўрѕЃріерѕѕріЏ рЅђрѕІ рІФрѕѕ рІерЅєрІ│ рЅђрѕѕрѕЮ
­ЪЉ░­ЪЈй	рѕЎрѕйрѕфрЅх ріерѕўрїІрѕерїЃ рїІрѕГрЇА рѕўрѕЃріерѕѕріЏ рІерЅєрІ│ рЅђрѕѕрѕЮ
­ЪЉ░­ЪЈЙ	рѕЎрѕйрѕфрЅх ріерѕўрїІрѕерїЃ рїІрѕГрЇА рѕўрѕЃріерѕѕріЏ рЅђрѕІ рІФрѕѕ рІерЅєрІ│ рЅђрѕѕрѕЮ
­ЪЉ░­ЪЈ┐	рѕЎрѕйрѕфрЅх рѕўрїІрѕерїЃ рІФрѕІрЅх: рїЦрЅЂрѕГ рІерЅєрІ│ рЅђрѕѕрѕЮ
­Ъц░	ріљрЇЇрѕ░ рїАрѕГ рѕ┤рЅх
­Ъц░­ЪЈ╗	ріљрЇЇрѕ░ рїАрѕГ рѕ┤рЅх: рЅђрѕІрѕЇ рІерЅєрІ│ рЅђрѕѕрѕЮ
­Ъц░­ЪЈ╝	ріљрЇЇрѕ░ рїАрѕГ рѕ┤рЅх: рѕўрѕЃріерѕѕріЏ рЅђрѕІ рІФрѕѕ рІерЅєрІ│ рЅђрѕѕрѕЮ
­Ъц░­ЪЈй	ріљрЇЇрѕ░ рїАрѕГ рѕ┤рЅх: рѕўрѕЃріерѕѕріЏ рІерЅєрІ│ рЅђрѕѕрѕЮ
­Ъц░­ЪЈЙ	ріљрЇЇрѕ░ рїАрѕГ рѕ┤рЅх: рѕўрѕЃріерѕѕріЏ-рїЦрЅЂрѕГ рІерЅєрІ│ рЅђрѕѕрѕЮ
­Ъц░­ЪЈ┐	ріљрЇЇрѕ░ рїАрѕГ рѕ┤рЅх: рїЦрЅЂрѕГ рІерЅєрІ│ рЅђрѕѕрѕЮ
­Ъц▒	рїАрЅх рЅарѕЏрїЦрЅБрЅх
­Ъц▒­ЪЈ╗	рїАрЅх рѕЏрїЦрЅБрЅх: рЅђрѕІрѕЇ рІерЅєрІ│ рЅђрѕѕрѕЮ
­Ъц▒­ЪЈ╝	рїАрЅх рѕЏрїЦрЅБрЅхрЇА рѕўрѕЃріерѕѕріЏ рЅђрѕІ рІФрѕѕ рІерЅєрІ│ рЅђрѕѕрѕЮ
­Ъц▒­ЪЈй	рїАрЅх рѕЏрїЦрЅБрЅх: рѕўрѕЃріерѕѕріЏ рІерЅєрІ│ рЅђрѕѕрѕЮ
­Ъц▒­ЪЈЙ	рїАрЅх рѕЏрїЦрЅБрЅхрЇА рѕўрѕЃріерѕѕріЏ рЅђрѕІ рІФрѕѕ рІерЅєрІ│ рЅђрѕѕрѕЮ
­Ъц▒­ЪЈ┐	рїАрЅх рѕЏрїЦрЅБрЅх: рїЦрЅЂрѕГ рІерЅєрІ│ рЅђрѕѕрѕЮ
­ЪЉ╝	рѕЋрЇЃріЋ рѕўрѕЇріаріГ
­ЪЉ╝­ЪЈ╗	рѕЋрЇЃріЋ рѕўрѕЇріаріГ: рЅђрѕІрѕЇ рІерЅєрІ│ рЅЃріЊ
­ЪЉ╝­ЪЈ╝	рѕЋрЇЃріЋ рѕўрѕЇріаріГ: рѕўрѕЃріерѕѕріЏ-рЅђрѕІрѕЇ рІерЅєрІ│ рЅђрѕѕрѕЮ
­ЪЉ╝­ЪЈй	рѕЋрЇЃріЋ рѕўрѕЇріаріГ: рѕўрѕЃріерѕѕріЏ рІерЅєрІ│ рЅђрѕѕрѕЮ
­ЪЉ╝­ЪЈЙ	рІерѕЋрЇЃріЋ рѕўрѕЇріаріГ: рѕўрѕЃріерѕѕріЏ-рїЦрЅЂрѕГ рІерЅєрІ│ рЅђрѕѕрѕЮ
­ЪЉ╝­ЪЈ┐	рѕЋрЇЃріЋ рѕўрѕЇріаріГ: рїЦрЅЂрѕГ рІерЅєрІ│ рЅђрѕѕрѕЮ
­ЪјЁ	рІерїѕріЊ ріарЅБрЅх
­ЪјЁ­ЪЈ╗	рѕ│ріЋрЅ│ ріГрѕІрІЇрѕхрЇА рЅђрѕІрѕЇ рІерЅєрІ│ рЅђрѕѕрѕЮ
­ЪјЁ­ЪЈ╝	рѕ│ріЋрЅ│ ріГрѕІрІЇрѕхрЇА рѕўрѕЃріерѕѕріЏ рЅђрѕІ рІФрѕѕ рІерЅєрІ│ рЅђрѕѕрѕЮ
­ЪјЁ­ЪЈй	рѕ│ріЋрЅ│ ріГрѕІрІЇрѕхрЇА рѕўрѕЃріерѕѕріЏ рІерЅєрІ│ рЅђрѕѕрѕЮ
­ЪјЁ­ЪЈЙ	рѕ│ріЋрЅ│ ріГрѕІрІЇрѕхрЇА рѕўрѕЃріерѕѕріЏ рЅђрѕІ рІФрѕѕ рІерЅєрІ│ рЅђрѕѕрѕЮ
­ЪјЁ­ЪЈ┐	рѕ│ріЋрЅ│ ріГрѕІрІЇрѕх: рїЦрЅЂрѕГ рІерЅєрІ│ рЅђрѕѕрѕЮ
­ЪцХ	рІѕрІГрІўрѕ« ріГрѕІрІЇрѕх
­ЪцХ­ЪЈ╗	рІѕрІГрІўрѕ« ріГрѕІрІЇрѕхрЇА рЅђрѕІрѕЇ рІерЅєрІ│ рЅђрѕѕрѕЮ
­ЪцХ­ЪЈ╝	рІѕрІГрІўрѕ« ріГрѕІрІЇрѕхрЇА рѕўрѕЃріерѕѕріЏ рЅђрѕІ рІФрѕѕ рІерЅєрІ│ рЅђрѕѕрѕЮ
­ЪцХ­ЪЈй	рІѕрІГрІўрѕ« ріГрѕІрІЇрѕхрЇА рѕўрѕЃріерѕѕріЏ рІерЅєрІ│ рЅђрѕѕрѕЮ
­ЪцХ­ЪЈЙ	рІѕрІГрІўрѕ« ріГрѕІрІЇрѕхрЇА рѕўрѕЃріерѕѕріЏ рЅђрѕІ рІФрѕѕ рІерЅєрІ│ рЅђрѕѕрѕЮ
­ЪцХ­ЪЈ┐	рІѕрІГрІўрѕ« ріГрѕІрІЇрѕхрЇА рїЦрЅЂрѕГ рІерЅєрІ│ рЅђрѕѕрѕЮ
­ЪдИ	рѕЇрІЋрѕѕ ріЃрІФрѕЇ
­ЪдИ­ЪЈ╗	рѕЇрІЋрѕѕ ріЃрІФрѕЇрЇА рЅђрѕІрѕЇ рІерЅєрІ│ рЅђрѕѕрѕЮ
­ЪдИ­ЪЈ╝	рѕЇрІЋрѕѕ ріЃрІФрѕЇрЇА рѕўрѕЃріерѕѕріЏ рЅђрѕІ рІФрѕѕ рІерЅєрІ│ рЅђрѕѕрѕЮ
­ЪдИ­ЪЈй	рѕЇрІЋрѕѕ ріЃрІФрѕЇрЇА рѕўрѕЃріерѕѕріЏ рІерЅєрІ│ рЅђрѕѕрѕЮ
­ЪдИ­ЪЈЙ	рѕЇрІЋрѕѕ ріЃрІФрѕЇрЇА рѕўрѕЃріерѕѕріЏ рЅђрѕІ рІФрѕѕ рІерЅєрІ│ рЅђрѕѕрѕЮ
­ЪдИ­ЪЈ┐	рѕЇрІЋрѕѕ ріЃрІФрѕЇрЇА рїЦрЅЂрѕГ рІерЅєрІ│ рЅђрѕѕрѕЮ
­ЪдИРђЇРЎђ№ИЈ	рѕ┤рЅх рѕЇрІЋрѕѕ ріЃрІФрѕЇ
­ЪдИРђЇРЎђ	рѕ┤рЅх рѕЇрІЋрѕѕ ріЃрІФрѕЇ
­ЪдИ­ЪЈ╗РђЇРЎђ№ИЈ	рѕ┤рЅх рѕЇрІЋрѕѕ ріЃрІФрѕЇрЇА рЅђрѕІрѕЇ рІерЅєрІ│ рЅђрѕѕрѕЮ
­ЪдИ­ЪЈ╗РђЇРЎђ	рѕ┤рЅх рѕЇрІЋрѕѕ ріЃрІФрѕЇрЇА рЅђрѕІрѕЇ рІерЅєрІ│ рЅђрѕѕрѕЮ
­ЪдИ­ЪЈ╝РђЇРЎђ№ИЈ	рѕ┤рЅх рѕЇрІЋрѕѕ ріЃрІФрѕЇрЇА рѕўрѕЃріерѕѕріЏ рЅђрѕІ рІФрѕѕ рІерЅєрІ│ рЅђрѕѕрѕЮ
­ЪдИ­ЪЈ╝РђЇРЎђ	рѕ┤рЅх рѕЇрІЋрѕѕ ріЃрІФрѕЇрЇА рѕўрѕЃріерѕѕріЏ рЅђрѕІ рІФрѕѕ рІерЅєрІ│ рЅђрѕѕрѕЮ
­ЪдИ­ЪЈйРђЇРЎђ№ИЈ	рѕ┤рЅх рѕЇрІЋрѕѕ ріЃрІФрѕЇрЇА рѕўрѕЃріерѕѕріЏ рІерЅєрІ│ рЅђрѕѕрѕЮ
­ЪдИ­ЪЈйРђЇРЎђ	рѕ┤рЅх рѕЇрІЋрѕѕ ріЃрІФрѕЇрЇА рѕўрѕЃріерѕѕріЏ рІерЅєрІ│ рЅђрѕѕрѕЮ
­ЪдИ­ЪЈЙРђЇРЎђ№ИЈ	рѕ┤рЅх рѕЇрІЋрѕѕ ріЃрІФрѕЇрЇА рѕўрѕЃріерѕѕріЏ рЅђрѕІ рІФрѕѕ рІерЅєрІ│ рЅђрѕѕрѕЮ
­ЪдИ­ЪЈЙРђЇРЎђ	рѕ┤рЅх рѕЇрІЋрѕѕ ріЃрІФрѕЇрЇА рѕўрѕЃріерѕѕріЏ рЅђрѕІ рІФрѕѕ рІерЅєрІ│ рЅђрѕѕрѕЮ
­ЪдИ­ЪЈ┐РђЇРЎђ№ИЈ	рѕ┤рЅх рѕЇрІЋрѕѕ ріЃрІФрѕЇрЇА рїЦрЅЂрѕГ рІерЅєрІ│ рЅђрѕѕрѕЮ
­ЪдИ­ЪЈ┐РђЇРЎђ	рѕ┤рЅх рѕЇрІЋрѕѕ ріЃрІФрѕЇрЇА рїЦрЅЂрѕГ рІерЅєрІ│ рЅђрѕѕрѕЮ
­ЪдИРђЇРЎѓ№ИЈ	рѕ░рІЇ рѕЇрІЋрѕѕ ріЃрІФрѕЇ
­ЪдИРђЇРЎѓ	рѕ░рІЇ рѕЇрІЋрѕѕ ріЃрІФрѕЇ
­ЪдИ­ЪЈ╗РђЇРЎѓ№ИЈ	рѕ░рІЇ рѕЇрІЋрѕѕ ріЃрІФрѕЇрЇА рЅђрѕІрѕЇ рІерЅєрІ│ рЅђрѕѕрѕЮ
­ЪдИ­ЪЈ╗РђЇРЎѓ	рѕ░рІЇ рѕЇрІЋрѕѕ ріЃрІФрѕЇрЇА рЅђрѕІрѕЇ рІерЅєрІ│ рЅђрѕѕрѕЮ
­ЪдИ­ЪЈ╝РђЇРЎѓ№ИЈ	рІѕріЋрІх рѕЇрІЋрѕѕ ріЃрІФрѕЇрЇА рѕўрѕЃріерѕѕріЏ рЅђрѕІ рІФрѕѕ рІерЅєрІ│ рЅђрѕѕрѕЮ
­ЪдИ­ЪЈ╝РђЇРЎѓ	рІѕріЋрІх рѕЇрІЋрѕѕ ріЃрІФрѕЇрЇА рѕўрѕЃріерѕѕріЏ рЅђрѕІ рІФрѕѕ рІерЅєрІ│ рЅђрѕѕрѕЮ
­ЪдИ­ЪЈйРђЇРЎѓ№ИЈ	рІѕріЋрІх рѕЇрІЋрѕѕ ріЃрІФрѕЇрЇА рѕўрѕЃріерѕѕріЏ рІерЅєрІ│ рЅђрѕѕрѕЮ
­ЪдИ­ЪЈйРђЇРЎѓ	рІѕріЋрІх рѕЇрІЋрѕѕ ріЃрІФрѕЇрЇА рѕўрѕЃріерѕѕріЏ рІерЅєрІ│ рЅђрѕѕрѕЮ
­ЪдИ­ЪЈЙРђЇРЎѓ№ИЈ	рІѕріЋрІх рѕЇрІЋрѕѕ ріЃрІФрѕЇрЇА рѕўрѕЃріерѕѕріЏ рЅђрѕІ рІФрѕѕ рІерЅєрІ│ рЅђрѕѕрѕЮ
­ЪдИ­ЪЈЙРђЇРЎѓ	рІѕріЋрІх рѕЇрІЋрѕѕ ріЃрІФрѕЇрЇА рѕўрѕЃріерѕѕріЏ рЅђрѕІ рІФрѕѕ рІерЅєрІ│ рЅђрѕѕрѕЮ
­ЪдИ­ЪЈ┐РђЇРЎѓ№ИЈ	рѕ░рІЇ рѕЇрІЋрѕѕ ріЃрІФрѕЇрЇА рїЦрЅЂрѕГ рІерЅєрІ│ рЅђрѕѕрѕЮ
­ЪдИ­ЪЈ┐РђЇРЎѓ	рѕ░рІЇ рѕЇрІЋрѕѕ ріЃрІФрѕЇрЇА рїЦрЅЂрѕГ рІерЅєрІ│ рЅђрѕѕрѕЮ
­Ъд╣	рѕ▒рЇљрѕГрЅфрѕіріЋ
­Ъд╣­ЪЈ╗	рѕ▒рЇљрѕГрЅфрѕІрІГріЋ: рЅђрѕІрѕЇ рІерЅєрІ│ рЅђрѕѕрѕЮ
­Ъд╣­ЪЈ╝	рѕ▒рЇљрѕГрЅфрѕіріЋрЇА рѕўрѕЃріерѕѕріЏ рЅђрѕІ рІФрѕѕ рІерЅєрІ│ рЅђрѕѕрѕЮ
­Ъд╣­ЪЈй	рѕ▒рЇљрѕГрЅфрѕІрІГріЋ: рѕўрѕЃріерѕѕріЏ рІерЅєрІ│ рЅђрѕѕрѕЮ
­Ъд╣­ЪЈЙ	рѕ▒рЇљрѕГрЅфрѕіріЋрЇА рѕўрѕЃріерѕѕріЏ рЅђрѕІ рІФрѕѕ рІерЅєрІ│ рЅђрѕѕрѕЮ
­Ъд╣­ЪЈ┐	рѕ▒рЇљрѕГрЅфрѕІрІГріЋ: рїЦрЅЂрѕГ рІерЅєрІ│ рЅђрѕѕрѕЮ
­Ъд╣РђЇРЎђ№ИЈ	рѕ┤рЅх рѕ▒рЇљрѕГрЅфрѕіріЋ
­Ъд╣РђЇРЎђ	рѕ┤рЅх рѕ▒рЇљрѕГрЅфрѕіріЋ
­Ъд╣­ЪЈ╗РђЇРЎђ№ИЈ	рѕ┤рЅх рѕ▒рЇљрѕГрЅфрѕІрІГріЋ: рЅђрѕІрѕЇ рІерЅєрІ│ рЅђрѕѕрѕЮ
­Ъд╣­ЪЈ╗РђЇРЎђ	рѕ┤рЅх рѕ▒рЇљрѕГрЅфрѕІрІГріЋ: рЅђрѕІрѕЇ рІерЅєрІ│ рЅђрѕѕрѕЮ
­Ъд╣­ЪЈ╝РђЇРЎђ№ИЈ	рѕ┤рЅх рѕ▒рЇљрѕГрЅфрѕіріЋрЇА рѕўрѕЃріерѕѕріЏ рЅђрѕІ рІФрѕѕ рІерЅєрІ│ рЅђрѕѕрѕЮ
­Ъд╣­ЪЈ╝РђЇРЎђ	рѕ┤рЅх рѕ▒рЇљрѕГрЅфрѕіріЋрЇА рѕўрѕЃріерѕѕріЏ рЅђрѕІ рІФрѕѕ рІерЅєрІ│ рЅђрѕѕрѕЮ
­Ъд╣­ЪЈйРђЇРЎђ№ИЈ	рѕ┤рЅх рѕ▒рЇљрѕГрЅфрѕІрІГріЋ: рѕўрѕЃріерѕѕріЏ рІерЅєрІ│ рЅђрѕѕрѕЮ
­Ъд╣­ЪЈйРђЇРЎђ	рѕ┤рЅх рѕ▒рЇљрѕГрЅфрѕІрІГріЋ: рѕўрѕЃріерѕѕріЏ рІерЅєрІ│ рЅђрѕѕрѕЮ
­Ъд╣­ЪЈЙРђЇРЎђ№ИЈ	рѕ┤рЅх рѕ▒рЇљрѕГрЅфрѕіріЋрЇА рѕўрѕЃріерѕѕріЏ рЅђрѕІ рІФрѕѕ рІерЅєрІ│ рЅђрѕѕрѕЮ
­Ъд╣­ЪЈЙРђЇРЎђ	рѕ┤рЅх рѕ▒рЇљрѕГрЅфрѕіріЋрЇА рѕўрѕЃріерѕѕріЏ рЅђрѕІ рІФрѕѕ рІерЅєрІ│ рЅђрѕѕрѕЮ
­Ъд╣­ЪЈ┐РђЇРЎђ№ИЈ	рѕ┤рЅх рѕ▒рЇљрѕГрЅфрѕІрІГріЋ: рїЦрЅЂрѕГ рІерЅєрІ│ рЅђрѕѕрѕЮ
­Ъд╣­ЪЈ┐РђЇРЎђ	рѕ┤рЅх рѕ▒рЇљрѕГрЅфрѕІрІГріЋ: рїЦрЅЂрѕГ рІерЅєрІ│ рЅђрѕѕрѕЮ
­Ъд╣РђЇРЎѓ№ИЈ	рѕ░рІЇ рѕ▒рЇљрѕГрЅфрѕіріЋ
­Ъд╣РђЇРЎѓ	рѕ░рІЇ рѕ▒рЇљрѕГрЅфрѕіріЋ
­Ъд╣­ЪЈ╗РђЇРЎѓ№ИЈ	man supervillain: рЅђрѕІрѕЇ рІерЅєрІ│ рЅђрѕѕрѕЮ
­Ъд╣­ЪЈ╗РђЇРЎѓ	man supervillain: рЅђрѕІрѕЇ рІерЅєрІ│ рЅђрѕѕрѕЮ
­Ъд╣­ЪЈ╝РђЇРЎѓ№ИЈ	man supervillain: рѕўрѕЃріерѕѕріЏ рЅђрѕІ рІФрѕѕ рІерЅєрІ│ рЅђрѕѕрѕЮ
­Ъд╣­ЪЈ╝РђЇРЎѓ	man supervillain: рѕўрѕЃріерѕѕріЏ рЅђрѕІ рІФрѕѕ рІерЅєрІ│ рЅђрѕѕрѕЮ
­Ъд╣­ЪЈйРђЇРЎѓ№ИЈ	man supervillain: рѕўрѕЃріерѕѕріЏ рІерЅєрІ│ рЅђрѕѕрѕЮ
­Ъд╣­ЪЈйРђЇРЎѓ	man supervillain: рѕўрѕЃріерѕѕріЏ рІерЅєрІ│ рЅђрѕѕрѕЮ
­Ъд╣­ЪЈЙРђЇРЎѓ№ИЈ	man supervillain: рѕўрѕЃріерѕѕріЏ рЅђрѕІ рІФрѕѕ рІерЅєрІ│ рЅђрѕѕрѕЮ
­Ъд╣­ЪЈЙРђЇРЎѓ	man supervillain: рѕўрѕЃріерѕѕріЏ рЅђрѕІ рІФрѕѕ рІерЅєрІ│ рЅђрѕѕрѕЮ
­Ъд╣­ЪЈ┐РђЇРЎѓ№ИЈ	man supervillain: рїЦрЅЂрѕГ рІерЅєрІ│ рЅђрѕѕрѕЮ
­Ъд╣­ЪЈ┐РђЇРЎѓ	man supervillain: рїЦрЅЂрѕГ рІерЅєрІ│ рЅђрѕѕрѕЮ
­ЪДЎ	рѕЏрїЁ
­ЪДЎ­ЪЈ╗	mage: рЅђрѕІрѕЇ рІерЅєрІ│ рЅђрѕѕрѕЮ
­ЪДЎ­ЪЈ╝	mage: рѕўрѕЃріерѕѕріЏ рЅђрѕІ рІФрѕѕ рІерЅєрІ│ рЅђрѕѕрѕЮ
­ЪДЎ­ЪЈй	mage: рѕўрѕЃріерѕѕріЏ рІерЅєрІ│ рЅђрѕѕрѕЮ
­ЪДЎ­ЪЈЙ	mage: рѕўрѕЃріерѕѕріЏ-рїЦрЅЂрѕГ рІерЅєрІ│ рЅђрѕѕрѕЮ
­ЪДЎ­ЪЈ┐	mage: рїЦрЅЂрѕГ рІерЅєрІ│ рЅђрѕѕрѕЮ
­ЪДЎРђЇРЎђ№ИЈ	рѕ┤рЅх рѕЏрїЁ
­ЪДЎРђЇРЎђ	рѕ┤рЅх рѕЏрїЁ
­ЪДЎ­ЪЈ╗РђЇРЎђ№ИЈ	рѕ┤рЅх mage: рЅђрѕІрѕЇ рІерЅєрІ│ рЅђрѕѕрѕЮ
­ЪДЎ­ЪЈ╗РђЇРЎђ	рѕ┤рЅх mage: рЅђрѕІрѕЇ рІерЅєрІ│ рЅђрѕѕрѕЮ
­ЪДЎ­ЪЈ╝РђЇРЎђ№ИЈ	рѕ┤рЅх mage: рѕўрѕЃріерѕѕріЏ рЅђрѕІ рІФрѕѕ рІерЅєрІ│ рЅђрѕѕрѕЮ
­ЪДЎ­ЪЈ╝РђЇРЎђ	рѕ┤рЅх mage: рѕўрѕЃріерѕѕріЏ рЅђрѕІ рІФрѕѕ рІерЅєрІ│ рЅђрѕѕрѕЮ
­ЪДЎ­ЪЈйРђЇРЎђ№ИЈ	рѕ┤рЅх mage: рѕўрѕЃріерѕѕріЏ рІерЅєрІ│ рЅђрѕѕрѕЮ
­ЪДЎ­ЪЈйРђЇРЎђ	рѕ┤рЅх mage: рѕўрѕЃріерѕѕріЏ рІерЅєрІ│ рЅђрѕѕрѕЮ
­ЪДЎ­ЪЈЙРђЇРЎђ№ИЈ	рѕ┤рЅх mage: рѕўрѕЃріерѕѕріЏ-рїЦрЅЂрѕГ рІерЅєрІ│ рЅђрѕѕрѕЮ
­ЪДЎ­ЪЈЙРђЇРЎђ	рѕ┤рЅх mage: рѕўрѕЃріерѕѕріЏ-рїЦрЅЂрѕГ рІерЅєрІ│ рЅђрѕѕрѕЮ
­ЪДЎ­ЪЈ┐РђЇРЎђ№ИЈ	рѕ┤рЅх mage: рїЦрЅЂрѕГ рІерЅєрІ│ рЅђрѕѕрѕЮ
­ЪДЎ­ЪЈ┐РђЇРЎђ	рѕ┤рЅх mage: рїЦрЅЂрѕГ рІерЅєрІ│ рЅђрѕѕрѕЮ
­ЪДЎРђЇРЎѓ№ИЈ	рѕ░рІЇ рѕЏрїї
­ЪДЎРђЇРЎѓ	рѕ░рІЇ рѕЏрїї
­ЪДЎ­ЪЈ╗РђЇРЎѓ№ИЈ	man mage: рЅђрѕІрѕЇ рІерЅєрІ│ рЅђрѕѕрѕЮ
­ЪДЎ­ЪЈ╗РђЇРЎѓ	man mage: рЅђрѕІрѕЇ рІерЅєрІ│ рЅђрѕѕрѕЮ
­ЪДЎ­ЪЈ╝РђЇРЎѓ№ИЈ	рѕЏріЋ mage: рѕўрѕЃріерѕѕріЏ рЅђрѕІ рІФрѕѕ рІерЅєрІ│ рЅђрѕѕрѕЮ
­ЪДЎ­ЪЈ╝РђЇРЎѓ	рѕЏріЋ mage: рѕўрѕЃріерѕѕріЏ рЅђрѕІ рІФрѕѕ рІерЅєрІ│ рЅђрѕѕрѕЮ
­ЪДЎ­ЪЈйРђЇРЎѓ№ИЈ	man mage: рѕўрѕЃріерѕѕріЏ рІерЅєрІ│ рЅђрѕѕрѕЮ
­ЪДЎ­ЪЈйРђЇРЎѓ	man mage: рѕўрѕЃріерѕѕріЏ рІерЅєрІ│ рЅђрѕѕрѕЮ
­ЪДЎ­ЪЈЙРђЇРЎѓ№ИЈ	man mage: рѕўрѕЃріерѕѕріЏ-рїЦрЅЂрѕГ рІерЅєрІ│ рЅђрѕѕрѕЮ
­ЪДЎ­ЪЈЙРђЇРЎѓ	man mage: рѕўрѕЃріерѕѕріЏ-рїЦрЅЂрѕГ рІерЅєрІ│ рЅђрѕѕрѕЮ
­ЪДЎ­ЪЈ┐РђЇРЎѓ№ИЈ	man mage: рїЦрЅЂрѕГ рІерЅєрІ│ рЅђрѕѕрѕЮ
­ЪДЎ­ЪЈ┐РђЇРЎѓ	man mage: рїЦрЅЂрѕГ рІерЅєрІ│ рЅђрѕѕрѕЮ
­ЪДџ	рЅ░рѕерЅх
­ЪДџ­ЪЈ╗	рЅ░рѕерЅх: рЅђрѕІрѕЇ рІерЅєрІ│ рЅђрѕѕрѕЮ
­ЪДџ­ЪЈ╝	рЅ░рѕерЅх: рѕўрѕЃріерѕѕріЏ рЅђрѕІ рІФрѕѕ рІерЅєрІ│ рЅђрѕѕрѕЮ
­ЪДџ­ЪЈй	рЅ░рѕерЅх: рѕўрѕЃріерѕѕріЏ рІерЅєрІ│ рЅђрѕѕрѕЮ
­ЪДџ­ЪЈЙ	рЅ░рѕерЅх: рѕўрѕЃріерѕѕріЏ-рїЦрЅЂрѕГ рІерЅєрІ│ рЅђрѕѕрѕЮ
­ЪДџ­ЪЈ┐	рЅ░рѕерЅх: рїЦрЅЂрѕГ рІерЅєрІ│ рЅђрѕѕрѕЮ
­ЪДџРђЇРЎђ№ИЈ	рѕ┤рЅх рЅ░рѕерЅх
­ЪДџРђЇРЎђ	рѕ┤рЅх рЅ░рѕерЅх
­ЪДџ­ЪЈ╗РђЇРЎђ№ИЈ	рѕ┤рЅх рЅ░рѕерЅх: рЅђрѕІрѕЇ рІерЅєрІ│ рЅђрѕѕрѕЮ
­ЪДџ­ЪЈ╗РђЇРЎђ	рѕ┤рЅх рЅ░рѕерЅх: рЅђрѕІрѕЇ рІерЅєрІ│ рЅђрѕѕрѕЮ
­ЪДџ­ЪЈ╝РђЇРЎђ№ИЈ	рѕ┤рЅх рЅ░рѕерЅх: рѕўрѕЃріерѕѕріЏ рЅђрѕІ рІФрѕѕ рІерЅєрІ│ рЅђрѕѕрѕЮ
­ЪДџ­ЪЈ╝РђЇРЎђ	рѕ┤рЅх рЅ░рѕерЅх: рѕўрѕЃріерѕѕріЏ рЅђрѕІ рІФрѕѕ рІерЅєрІ│ рЅђрѕѕрѕЮ
­ЪДџ­ЪЈйРђЇРЎђ№ИЈ	рѕ┤рЅх рЅ░рѕерЅх: рѕўрѕЃріерѕѕріЏ рІерЅєрІ│ рЅђрѕѕрѕЮ
­ЪДџ­ЪЈйРђЇРЎђ	рѕ┤рЅх рЅ░рѕерЅх: рѕўрѕЃріерѕѕріЏ рІерЅєрІ│ рЅђрѕѕрѕЮ
­ЪДџ­ЪЈЙРђЇРЎђ№ИЈ	рІерѕ┤рЅх рЅ░рѕерЅхрЇА рѕўрѕЃріерѕѕріЏ рЅђрѕІ рІФрѕѕ рІерЅєрІ│ рЅђрѕѕрѕЮ
­ЪДџ­ЪЈЙРђЇРЎђ	рІерѕ┤рЅх рЅ░рѕерЅхрЇА рѕўрѕЃріерѕѕріЏ рЅђрѕІ рІФрѕѕ рІерЅєрІ│ рЅђрѕѕрѕЮ
­ЪДџ­ЪЈ┐РђЇРЎђ№ИЈ	рѕ┤рЅх рЅ░рѕерЅх: рїЦрЅЂрѕГ рІерЅєрІ│ рЅђрѕѕрѕЮ
­ЪДџ­ЪЈ┐РђЇРЎђ	рѕ┤рЅх рЅ░рѕерЅх: рїЦрЅЂрѕГ рІерЅєрІ│ рЅђрѕѕрѕЮ
­ЪДџРђЇРЎѓ№ИЈ	рІерѕ░рІЇ рЅ░рѕерЅх
­ЪДџРђЇРЎѓ	рІерѕ░рІЇ рЅ░рѕерЅх
­ЪДџ­ЪЈ╗РђЇРЎѓ№ИЈ	рѕ░рІЇ рЅ░рѕерЅх: рЅђрѕІрѕЇ рІерЅєрІ│ рЅђрѕѕрѕЮ
­ЪДџ­ЪЈ╗РђЇРЎѓ	рѕ░рІЇ рЅ░рѕерЅх: рЅђрѕІрѕЇ рІерЅєрІ│ рЅђрѕѕрѕЮ
­ЪДџ­ЪЈ╝РђЇРЎѓ№ИЈ	рІерѕ░рІЇ рЅ░рѕерЅх: рѕўрѕЃріерѕѕріЏ рЅђрѕІ рІФрѕѕ рІерЅєрІ│ рЅђрѕѕрѕЮ
­ЪДџ­ЪЈ╝РђЇРЎѓ	рІерѕ░рІЇ рЅ░рѕерЅх: рѕўрѕЃріерѕѕріЏ рЅђрѕІ рІФрѕѕ рІерЅєрІ│ рЅђрѕѕрѕЮ
­ЪДџ­ЪЈйРђЇРЎѓ№ИЈ	рІѕріЋрІх рЅ░рѕерЅх: рѕўрѕЃріерѕѕріЏ рІерЅєрІ│ рЅђрѕѕрѕЮ
­ЪДџ­ЪЈйРђЇРЎѓ	рІѕріЋрІх рЅ░рѕерЅх: рѕўрѕЃріерѕѕріЏ рІерЅєрІ│ рЅђрѕѕрѕЮ
­ЪДџ­ЪЈЙРђЇРЎѓ№ИЈ	рІерѕ░рІЇ рЅ░рѕерЅх: рѕўрѕЃріерѕѕріЏ-рїЦрЅЂрѕГ рІерЅєрІ│ рЅђрѕѕрѕЮ
­ЪДџ­ЪЈЙРђЇРЎѓ	рІерѕ░рІЇ рЅ░рѕерЅх: рѕўрѕЃріерѕѕріЏ-рїЦрЅЂрѕГ рІерЅєрІ│ рЅђрѕѕрѕЮ
­ЪДџ­ЪЈ┐РђЇРЎѓ№ИЈ	рѕ░рІЇ рЅ░рѕерЅх: рїЦрЅЂрѕГ рІерЅєрІ│ рЅђрѕѕрѕЮ
­ЪДџ­ЪЈ┐РђЇРЎѓ	рѕ░рІЇ рЅ░рѕерЅх: рїЦрЅЂрѕГ рІерЅєрІ│ рЅђрѕѕрѕЮ
­ЪДЏ	рЅФрѕЮрЇЊрІерѕГ
­ЪДЏ­ЪЈ╗	рЅФрѕЮрЇЊрІерѕГ: рЅђрѕІрѕЇ рІерЅєрІ│ рЅђрѕѕрѕЮ
­ЪДЏ­ЪЈ╝	рЅФрѕЮрЇЊрІерѕГ: рѕўрѕЃріерѕѕріЏ рЅђрѕІ рІФрѕѕ рІерЅєрІ│ рЅђрѕѕрѕЮ
­ЪДЏ­ЪЈй	рЅФрѕЮрЇЊрІерѕГ: рѕўрѕЃріерѕѕріЏ рІерЅєрІ│ рЅђрѕѕрѕЮ
­ЪДЏ­ЪЈЙ	рЅФрѕЮрЇЊрІерѕГ: рѕўрѕЃріерѕѕріЏ-рїЦрЅЂрѕГ рІерЅєрІ│ рЅђрѕѕрѕЮ
­ЪДЏ­ЪЈ┐	рЅФрѕЮрЇЊрІерѕГ: рїЦрЅЂрѕГ рІерЅєрІ│ рЅђрѕѕрѕЮ
­ЪДЏРђЇРЎђ№ИЈ	рѕ┤рЅх рЅФрѕЮрЇЊрІерѕГ
­ЪДЏРђЇРЎђ	рѕ┤рЅх рЅФрѕЮрЇЊрІерѕГ
­ЪДЏ­ЪЈ╗РђЇРЎђ№ИЈ	рѕ┤рЅх рЅФрѕЮрЇЊрІерѕГ: рЅђрѕІрѕЇ рІерЅєрІ│ рЅђрѕѕрѕЮ
­ЪДЏ­ЪЈ╗РђЇРЎђ	рѕ┤рЅх рЅФрѕЮрЇЊрІерѕГ: рЅђрѕІрѕЇ рІерЅєрІ│ рЅђрѕѕрѕЮ
­ЪДЏ­ЪЈ╝РђЇРЎђ№ИЈ	рѕ┤рЅх рЅФрѕЮрЇЊрІерѕГрЇА рѕўрѕЃріерѕѕріЏ рЅђрѕІ рІФрѕѕ рІерЅєрІ│ рЅђрѕѕрѕЮ
­ЪДЏ­ЪЈ╝РђЇРЎђ	рѕ┤рЅх рЅФрѕЮрЇЊрІерѕГрЇА рѕўрѕЃріерѕѕріЏ рЅђрѕІ рІФрѕѕ рІерЅєрІ│ рЅђрѕѕрѕЮ
­ЪДЏ­ЪЈйРђЇРЎђ№ИЈ	рѕ┤рЅх рЅФрѕЮрЇЊрІерѕГ: рѕўрѕЃріерѕѕріЏ рІерЅєрІ│ рЅђрѕѕрѕЮ
­ЪДЏ­ЪЈйРђЇРЎђ	рѕ┤рЅх рЅФрѕЮрЇЊрІерѕГ: рѕўрѕЃріерѕѕріЏ рІерЅєрІ│ рЅђрѕѕрѕЮ
­ЪДЏ­ЪЈЙРђЇРЎђ№ИЈ	рѕ┤рЅх рЅФрѕЮрЇЊрІерѕГ: рѕўрѕЃріерѕѕріЏ-рїЦрЅЂрѕГ рІерЅєрІ│ рЅђрѕѕрѕЮ
­ЪДЏ­ЪЈЙРђЇРЎђ	рѕ┤рЅх рЅФрѕЮрЇЊрІерѕГ: рѕўрѕЃріерѕѕріЏ-рїЦрЅЂрѕГ рІерЅєрІ│ рЅђрѕѕрѕЮ
­ЪДЏ­ЪЈ┐РђЇРЎђ№ИЈ	рѕ┤рЅх рЅФрѕЮрЇЊрІерѕГ: рїЦрЅЂрѕГ рІерЅєрІ│ рЅђрѕѕрѕЮ
­ЪДЏ­ЪЈ┐РђЇРЎђ	рѕ┤рЅх рЅФрѕЮрЇЊрІерѕГ: рїЦрЅЂрѕГ рІерЅєрІ│ рЅђрѕѕрѕЮ
­ЪДЏРђЇРЎѓ№ИЈ	рѕ░рІЇ рЅФрѕЮрЇЊрІерѕГ
­ЪДЏРђЇРЎѓ	рѕ░рІЇ рЅФрѕЮрЇЊрІерѕГ
­ЪДЏ­ЪЈ╗РђЇРЎѓ№ИЈ	рѕ░рІЇ рЅФрѕЮрЇЊрІерѕГ: рЅђрѕІрѕЇ рІерЅєрІ│ рЅђрѕѕрѕЮ
­ЪДЏ­ЪЈ╗РђЇРЎѓ	рѕ░рІЇ рЅФрѕЮрЇЊрІерѕГ: рЅђрѕІрѕЇ рІерЅєрІ│ рЅђрѕѕрѕЮ
­ЪДЏ­ЪЈ╝РђЇРЎѓ№ИЈ	рѕ░рІЇ рЅФрѕЮрЇЊрІерѕГ: рѕўрѕЃріерѕѕріЏ рЅђрѕІ рІФрѕѕ рІерЅєрІ│ рЅђрѕѕрѕЮ
­ЪДЏ­ЪЈ╝РђЇРЎѓ	рѕ░рІЇ рЅФрѕЮрЇЊрІерѕГ: рѕўрѕЃріерѕѕріЏ рЅђрѕІ рІФрѕѕ рІерЅєрІ│ рЅђрѕѕрѕЮ
­ЪДЏ­ЪЈйРђЇРЎѓ№ИЈ	рѕ░рІЇ рЅФрѕЮрЇЊрІерѕГ: рѕўрѕЃріерѕѕріЏ рІерЅєрІ│ рЅђрѕѕрѕЮ
­ЪДЏ­ЪЈйРђЇРЎѓ	рѕ░рІЇ рЅФрѕЮрЇЊрІерѕГ: рѕўрѕЃріерѕѕріЏ рІерЅєрІ│ рЅђрѕѕрѕЮ
­ЪДЏ­ЪЈЙРђЇРЎѓ№ИЈ	рѕ░рІЇ рЅФрѕЮрЇЊрІерѕГ: рѕўрѕЃріерѕѕріЏ-рїЦрЅЂрѕГ рІерЅєрІ│ рЅђрѕѕрѕЮ
­ЪДЏ­ЪЈЙРђЇРЎѓ	рѕ░рІЇ рЅФрѕЮрЇЊрІерѕГ: рѕўрѕЃріерѕѕріЏ-рїЦрЅЂрѕГ рІерЅєрІ│ рЅђрѕѕрѕЮ
­ЪДЏ­ЪЈ┐РђЇРЎѓ№ИЈ	рѕ░рІЇ рЅФрѕЮрЇЊрІерѕГ: рїЦрЅЂрѕГ рІерЅєрІ│ рЅђрѕѕрѕЮ
­ЪДЏ­ЪЈ┐РђЇРЎѓ	рѕ░рІЇ рЅФрѕЮрЇЊрІерѕГ: рїЦрЅЂрѕГ рІерЅєрІ│ рЅђрѕѕрѕЮ
­ЪДю	merperson
­ЪДю­ЪЈ╗	merperson: рЅђрѕІрѕЇ рІерЅєрІ│ рЅђрѕѕрѕЮ
­ЪДю­ЪЈ╝	merperson: рѕўрѕЃріерѕѕріЏ рЅђрѕІ рІФрѕѕ рІерЅєрІ│ рЅђрѕѕрѕЮ
­ЪДю­ЪЈй	merperson: рѕўрѕЃріерѕѕріЏ рІерЅєрІ│ рЅђрѕѕрѕЮ
­ЪДю­ЪЈЙ	merperson: рѕўрѕЃріерѕѕріЏ-рїЦрЅЂрѕГ рІерЅєрІ│ рЅђрѕѕрѕЮ
­ЪДю­ЪЈ┐	merperson: рїЦрЅЂрѕГ рІерЅєрІ│ рЅђрѕѕрѕЮ
­ЪДюРђЇРЎђ№ИЈ	mermaid
­ЪДюРђЇРЎђ	mermaid
­ЪДю­ЪЈ╗РђЇРЎђ№ИЈ	mermaid: рЅђрѕІрѕЇ рІерЅєрІ│ рЅђрѕѕрѕЮ
­ЪДю­ЪЈ╗РђЇРЎђ	mermaid: рЅђрѕІрѕЇ рІерЅєрІ│ рЅђрѕѕрѕЮ
­ЪДю­ЪЈ╝РђЇРЎђ№ИЈ	mermaid: рѕўрѕЃріерѕѕріЏ рЅђрѕІ рІФрѕѕ рІерЅєрІ│ рЅђрѕѕрѕЮ
­ЪДю­ЪЈ╝РђЇРЎђ	mermaid: рѕўрѕЃріерѕѕріЏ рЅђрѕІ рІФрѕѕ рІерЅєрІ│ рЅђрѕѕрѕЮ
­ЪДю­ЪЈйРђЇРЎђ№ИЈ	mermaid: рѕўрѕЃріерѕѕріЏ рІерЅєрІ│ рЅђрѕѕрѕЮ
­ЪДю­ЪЈйРђЇРЎђ	mermaid: рѕўрѕЃріерѕѕріЏ рІерЅєрІ│ рЅђрѕѕрѕЮ
­ЪДю­ЪЈЙРђЇРЎђ№ИЈ	mermaid: рѕўрѕЃріерѕѕріЏ-рїЦрЅЂрѕГ рІерЅєрІ│ рЅђрѕѕрѕЮ
­ЪДю­ЪЈЙРђЇРЎђ	mermaid: рѕўрѕЃріерѕѕріЏ-рїЦрЅЂрѕГ рІерЅєрІ│ рЅђрѕѕрѕЮ
­ЪДю­ЪЈ┐РђЇРЎђ№ИЈ	mermaid: рїЦрЅЂрѕГ рІерЅєрІ│ рЅђрѕѕрѕЮ
­ЪДю­ЪЈ┐РђЇРЎђ	mermaid: рїЦрЅЂрѕГ рІерЅєрІ│ рЅђрѕѕрѕЮ
­ЪДюРђЇРЎѓ№ИЈ	рѕўрѕГрѕЏріЋ
­ЪДюРђЇРЎѓ	рѕўрѕГрѕЏріЋ
­ЪДю­ЪЈ╗РђЇРЎѓ№ИЈ	рѕюрѕГрѕЏріЋ: рЅђрѕІрѕЇ рІерЅєрІ│ рЅђрѕѕрѕЮ
­ЪДю­ЪЈ╗РђЇРЎѓ	рѕюрѕГрѕЏріЋ: рЅђрѕІрѕЇ рІерЅєрІ│ рЅђрѕѕрѕЮ
­ЪДю­ЪЈ╝РђЇРЎѓ№ИЈ	рѕюрѕГрѕЏріЋрЇА рѕўрѕЃріерѕѕріЏ рЅђрѕІ рІФрѕѕ рІерЅєрІ│ рЅђрѕѕрѕЮ
­ЪДю­ЪЈ╝РђЇРЎѓ	рѕюрѕГрѕЏріЋрЇА рѕўрѕЃріерѕѕріЏ рЅђрѕІ рІФрѕѕ рІерЅєрІ│ рЅђрѕѕрѕЮ
­ЪДю­ЪЈйРђЇРЎѓ№ИЈ	рѕюрѕГрѕЏріЋ: рѕўрѕЃріерѕѕріЏ рІерЅєрІ│ рЅђрѕѕрѕЮ
­ЪДю­ЪЈйРђЇРЎѓ	рѕюрѕГрѕЏріЋ: рѕўрѕЃріерѕѕріЏ рІерЅєрІ│ рЅђрѕѕрѕЮ
­ЪДю­ЪЈЙРђЇРЎѓ№ИЈ	рѕюрѕГрѕЏріЋ: рѕўрѕЃріерѕѕріЏ-рїЦрЅЂрѕГ рІерЅєрІ│ рЅђрѕѕрѕЮ
­ЪДю­ЪЈЙРђЇРЎѓ	рѕюрѕГрѕЏріЋ: рѕўрѕЃріерѕѕріЏ-рїЦрЅЂрѕГ рІерЅєрІ│ рЅђрѕѕрѕЮ
­ЪДю­ЪЈ┐РђЇРЎѓ№ИЈ	рѕюрѕГрѕЏріЋ: рїЦрЅЂрѕГ рІерЅєрІ│ рЅђрѕѕрѕЮ
­ЪДю­ЪЈ┐РђЇРЎѓ	рѕюрѕГрѕЏріЋ: рїЦрЅЂрѕГ рІерЅєрІ│ рЅђрѕѕрѕЮ
­ЪДЮ	ріцрѕЇрЇЇ
­ЪДЮ­ЪЈ╗	elf: рЅђрѕІрѕЇ рІерЅєрІ│ рЅђрѕѕрѕЮ
­ЪДЮ­ЪЈ╝	Elf: рѕўрѕЃріерѕѕріЏ рЅђрѕІ рІФрѕѕ рІерЅєрІ│ рЅђрѕѕрѕЮ
­ЪДЮ­ЪЈй	Elf: рѕўрѕЃріерѕѕріЏ рІерЅєрІ│ рЅђрѕѕрѕЮ
­ЪДЮ­ЪЈЙ	Elf: рѕўрѕЃріерѕѕріЏ-рїЦрЅЂрѕГ рІерЅєрІ│ рЅђрѕѕрѕЮ
­ЪДЮ­ЪЈ┐	Elf: рїЦрЅЂрѕГ рІерЅєрІ│ рЅђрѕѕрѕЮ
­ЪДЮРђЇРЎђ№ИЈ	рѕ┤рЅх elf
­ЪДЮРђЇРЎђ	рѕ┤рЅх elf
­ЪДЮ­ЪЈ╗РђЇРЎђ№ИЈ	рѕ┤рЅх elf: рЅђрѕІрѕЇ рІерЅєрІ│ рЅђрѕѕрѕЮ
­ЪДЮ­ЪЈ╗РђЇРЎђ	рѕ┤рЅх elf: рЅђрѕІрѕЇ рІерЅєрІ│ рЅђрѕѕрѕЮ
­ЪДЮ­ЪЈ╝РђЇРЎђ№ИЈ	рѕ┤рЅх ріцрѕЇрЇЇрЇА рѕўрѕЃріерѕѕріЏ рЅђрѕІ рІФрѕѕ рІерЅєрІ│ рЅђрѕѕрѕЮ
­ЪДЮ­ЪЈ╝РђЇРЎђ	рѕ┤рЅх ріцрѕЇрЇЇрЇА рѕўрѕЃріерѕѕріЏ рЅђрѕІ рІФрѕѕ рІерЅєрІ│ рЅђрѕѕрѕЮ
­ЪДЮ­ЪЈйРђЇРЎђ№ИЈ	рѕ┤рЅх Elf: рѕўрѕЃріерѕѕріЏ рІерЅєрІ│ рЅђрѕѕрѕЮ
­ЪДЮ­ЪЈйРђЇРЎђ	рѕ┤рЅх Elf: рѕўрѕЃріерѕѕріЏ рІерЅєрІ│ рЅђрѕѕрѕЮ
­ЪДЮ­ЪЈЙРђЇРЎђ№ИЈ	рѕ┤рЅх ріцрѕЇрЇЇрЇА рѕўрѕЃріерѕѕріЏ рЅђрѕІ рІФрѕѕ рІерЅєрІ│ рЅђрѕѕрѕЮ
­ЪДЮ­ЪЈЙРђЇРЎђ	рѕ┤рЅх ріцрѕЇрЇЇрЇА рѕўрѕЃріерѕѕріЏ рЅђрѕІ рІФрѕѕ рІерЅєрІ│ рЅђрѕѕрѕЮ
­ЪДЮ­ЪЈ┐РђЇРЎђ№ИЈ	рѕ┤рЅх elf: рїЦрЅЂрѕГ рІерЅєрІ│ рЅђрѕѕрѕЮ
­ЪДЮ­ЪЈ┐РђЇРЎђ	рѕ┤рЅх elf: рїЦрЅЂрѕГ рІерЅєрІ│ рЅђрѕѕрѕЮ
­ЪДЮРђЇРЎѓ№ИЈ	рѕ░рІЇ ріцрѕЇрЇЇ
­ЪДЮРђЇРЎѓ	рѕ░рІЇ ріцрѕЇрЇЇ
­ЪДЮ­ЪЈ╗РђЇРЎѓ№ИЈ	man elf: рЅђрѕІрѕЇ рІерЅєрІ│ рЅђрѕѕрѕЮ
­ЪДЮ­ЪЈ╗РђЇРЎѓ	man elf: рЅђрѕІрѕЇ рІерЅєрІ│ рЅђрѕѕрѕЮ
­ЪДЮ­ЪЈ╝РђЇРЎѓ№ИЈ	man elf: рѕўрѕЃріерѕѕріЏ рЅђрѕІ рІФрѕѕ рІерЅєрІ│ рЅђрѕѕрѕЮ
­ЪДЮ­ЪЈ╝РђЇРЎѓ	man elf: рѕўрѕЃріерѕѕріЏ рЅђрѕІ рІФрѕѕ рІерЅєрІ│ рЅђрѕѕрѕЮ
­ЪДЮ­ЪЈйРђЇРЎѓ№ИЈ	man elf: рѕўрѕЃріерѕѕріЏ рІерЅєрІ│ рЅђрѕѕрѕЮ
­ЪДЮ­ЪЈйРђЇРЎѓ	man elf: рѕўрѕЃріерѕѕріЏ рІерЅєрІ│ рЅђрѕѕрѕЮ
­ЪДЮ­ЪЈЙРђЇРЎѓ№ИЈ	man elf: рѕўрѕЃріерѕѕріЏ-рїЦрЅЂрѕГ рІерЅєрІ│ рЅђрѕѕрѕЮ
­ЪДЮ­ЪЈЙРђЇРЎѓ	man elf: рѕўрѕЃріерѕѕріЏ-рїЦрЅЂрѕГ рІерЅєрІ│ рЅђрѕѕрѕЮ
­ЪДЮ­ЪЈ┐РђЇРЎѓ№ИЈ	man elf: рїЦрЅЂрѕГ рІерЅєрІ│ рЅђрѕѕрѕЮ
­ЪДЮ­ЪЈ┐РђЇРЎѓ	man elf: рїЦрЅЂрѕГ рІерЅєрІ│ рЅђрѕѕрѕЮ
­ЪДъ	рїѓріњ
­ЪДъРђЇРЎђ№ИЈ	рѕ┤рЅх рїѓріњ
­ЪДъРђЇРЎђ	рѕ┤рЅх рїѓріњ
­ЪДъРђЇРЎѓ№ИЈ	рѕ░рІЇ рїѓріњ
­ЪДъРђЇРЎѓ	рѕ░рІЇ рїѓріњ
­ЪДЪ	рІърѕЮрЅб
­ЪДЪРђЇРЎђ№ИЈ	рѕ┤рЅх рІърѕЮрЅб
­ЪДЪРђЇРЎђ	рѕ┤рЅх рІърѕЮрЅб
­ЪДЪРђЇРЎѓ№ИЈ	рѕ░рІЇ рІърѕЮрЅб
­ЪДЪРђЇРЎѓ	рѕ░рІЇ рІърѕЮрЅб
­ЪЎЇ	рЇірЅх рѕѕрЇірЅх рІерЅ░рі«рѕ│рЅ░рѕе рѕ░рІЇ
­ЪЎЇ­ЪЈ╗	рІерЅ░рі«рѕ│рЅ░рѕе рѕ░рІЇрЇА рЅђрѕІрѕЇ рІерЅєрІ│ рЅђрѕѕрѕЮ
­ЪЎЇ­ЪЈ╝	рІерЅ░рі«рѕ│рЅ░рѕе рѕ░рІЇрЇА рѕўрѕЃріерѕѕріЏ рЅђрѕІ рІФрѕѕ рІерЅєрІ│ рЅђрѕѕрѕЮ
­ЪЎЇ­ЪЈй	рІерЅ░рі«рѕ│рЅ░рѕе рѕ░рІЇрЇА рѕўрѕЃріерѕѕріЏ рІерЅєрІ│ рЅђрѕѕрѕЮ
­ЪЎЇ­ЪЈЙ	рІерЅ░рі«рѕ│рЅ░рѕе рѕ░рІЇрЇА рѕўрѕЃріерѕѕріЏ рЅђрѕІ рІФрѕѕ рІерЅєрІ│ рЅђрѕѕрѕЮ
­ЪЎЇ­ЪЈ┐	рІерЅ░рі«рѕ│рЅ░рѕе рѕ░рІЇрЇА рїЦрЅЂрѕГ рІерЅєрІ│ рЅђрѕѕрѕЮ
­ЪЎЇРђЇРЎѓ№ИЈ	рѕ░рІЇрІгрІЇ рЇірЅ▒ріЋ ріЦрІФрЇѕрѕерѕ░
­ЪЎЇРђЇРЎѓ	рѕ░рІЇрІгрІЇ рЇірЅ▒ріЋ ріЦрІФрЇѕрѕерѕ░
­ЪЎЇ­ЪЈ╗РђЇРЎѓ№ИЈ	рІерЅ░рі«рѕ│рЅ░рѕе рѕ░рІЇрЇА рЅђрѕІрѕЇ рІерЅєрІ│ рЅђрѕѕрѕЮ
­ЪЎЇ­ЪЈ╗РђЇРЎѓ	рІерЅ░рі«рѕ│рЅ░рѕе рѕ░рІЇрЇА рЅђрѕІрѕЇ рІерЅєрІ│ рЅђрѕѕрѕЮ
­ЪЎЇ­ЪЈ╝РђЇРЎѓ№ИЈ	рІерЅ░рі«рѕ│рЅ░рѕе рѕ░рІЇрЇА рѕўрѕЃріерѕѕріЏ рЅђрѕІ рІФрѕѕ рІерЅєрІ│ рЅђрѕѕрѕЮ
­ЪЎЇ­ЪЈ╝РђЇРЎѓ	рІерЅ░рі«рѕ│рЅ░рѕе рѕ░рІЇрЇА рѕўрѕЃріерѕѕріЏ рЅђрѕІ рІФрѕѕ рІерЅєрІ│ рЅђрѕѕрѕЮ
­ЪЎЇ­ЪЈйРђЇРЎѓ№ИЈ	рѕўрі«рѕ│рЅ░рѕГ рІѕріЋрІхрЇА рѕўрѕЃріерѕѕріЏ рІерЅєрІ│ рЅђрѕѕрѕЮ
­ЪЎЇ­ЪЈйРђЇРЎѓ	рѕўрі«рѕ│рЅ░рѕГ рІѕріЋрІхрЇА рѕўрѕЃріерѕѕріЏ рІерЅєрІ│ рЅђрѕѕрѕЮ
­ЪЎЇ­ЪЈЙРђЇРЎѓ№ИЈ	рІерЅ░рі«рѕ│рЅ░рѕе рѕ░рІЇрЇА рѕўрѕЃріерѕѕріЏ рЅђрѕІ рІФрѕѕ рІерЅєрІ│ рЅђрѕѕрѕЮ
­ЪЎЇ­ЪЈЙРђЇРЎѓ	рІерЅ░рі«рѕ│рЅ░рѕе рѕ░рІЇрЇА рѕўрѕЃріерѕѕріЏ рЅђрѕІ рІФрѕѕ рІерЅєрІ│ рЅђрѕѕрѕЮ
­ЪЎЇ­ЪЈ┐РђЇРЎѓ№ИЈ	рІерЅ░рі«рѕ│рЅ░рѕе рѕ░рІЇрЇА рїЦрЅЂрѕГ рІерЅєрІ│ рЅђрѕѕрѕЮ
­ЪЎЇ­ЪЈ┐РђЇРЎѓ	рІерЅ░рі«рѕ│рЅ░рѕе рѕ░рІЇрЇА рїЦрЅЂрѕГ рІерЅєрІ│ рЅђрѕѕрѕЮ
­ЪЎЇРђЇРЎђ№ИЈ	ріаріЋрїѕрЅиріЋ рїерЇѕрѕерЅй
­ЪЎЇРђЇРЎђ	ріаріЋрїѕрЅиріЋ рїерЇѕрѕерЅй
­ЪЎЇ­ЪЈ╗РђЇРЎђ№ИЈ	рІерЅ░рі«рѕ│рЅ░рѕерЅй рѕ┤рЅхрЇА рЅђрѕІрѕЇ рІерЅєрІ│ рЅђрѕѕрѕЮ
­ЪЎЇ­ЪЈ╗РђЇРЎђ	рІерЅ░рі«рѕ│рЅ░рѕерЅй рѕ┤рЅхрЇА рЅђрѕІрѕЇ рІерЅєрІ│ рЅђрѕѕрѕЮ
­ЪЎЇ­ЪЈ╝РђЇРЎђ№ИЈ	рІерЅ░рі«рѕ│рЅ░рѕерЅй рѕ┤рЅхрЇА рѕўрѕЃріерѕѕріЏ рЅђрѕІ рІФрѕѕ рІерЅєрІ│ рЅђрѕѕрѕЮ
­ЪЎЇ­ЪЈ╝РђЇРЎђ	рІерЅ░рі«рѕ│рЅ░рѕерЅй рѕ┤рЅхрЇА рѕўрѕЃріерѕѕріЏ рЅђрѕІ рІФрѕѕ рІерЅєрІ│ рЅђрѕѕрѕЮ
­ЪЎЇ­ЪЈйРђЇРЎђ№ИЈ	рІерЅ░рі«рѕ│рЅ░рѕерЅй рѕ┤рЅхрЇА рѕўрѕЃріерѕѕріЏ рІерЅєрІ│ рЅђрѕѕрѕЮ
­ЪЎЇ­ЪЈйРђЇРЎђ	рІерЅ░рі«рѕ│рЅ░рѕерЅй рѕ┤рЅхрЇА рѕўрѕЃріерѕѕріЏ рІерЅєрІ│ рЅђрѕѕрѕЮ
­ЪЎЇ­ЪЈЙРђЇРЎђ№ИЈ	рІерЅ░рі«рѕ│рЅ░рѕерЅй рѕ┤рЅхрЇА рѕўрѕЃріерѕѕріЏ рЅђрѕІ рІФрѕѕ рІерЅєрІ│ рЅђрѕѕрѕЮ
­ЪЎЇ­ЪЈЙРђЇРЎђ	рІерЅ░рі«рѕ│рЅ░рѕерЅй рѕ┤рЅхрЇА рѕўрѕЃріерѕѕріЏ рЅђрѕІ рІФрѕѕ рІерЅєрІ│ рЅђрѕѕрѕЮ
­ЪЎЇ­ЪЈ┐РђЇРЎђ№ИЈ	рІерЅ░рі«рѕ│рЅ░рѕерЅй рѕ┤рЅхрЇА рїЦрЅЂрѕГ рІерЅєрІ│ рЅђрѕѕрѕЮ
­ЪЎЇ­ЪЈ┐РђЇРЎђ	рІерЅ░рі«рѕ│рЅ░рѕерЅй рѕ┤рЅхрЇА рїЦрЅЂрѕГ рІерЅєрІ│ рЅђрѕѕрѕЮ
­ЪЎј	рѕ░рІЇ ріЦрІерї«ріИ
­ЪЎј­ЪЈ╗	рѕ░рІЇ ріЦрІерї«ріИрЇА рЅђрѕІрѕЇ рІерЅєрІ│ рЅђрѕѕрѕЮ
­ЪЎј­ЪЈ╝	рѕ░рІЇ ріЦрІерї«ріИрЇА рѕўрѕЃріерѕѕріЏ рЅђрѕІ рІФрѕѕ рІерЅєрІ│ рЅђрѕѕрѕЮ
­ЪЎј­ЪЈй	рѕ░рІЇ ріЦрІерї«ріИ: рѕўрѕЃріерѕѕріЏ рІерЅєрІ│ рЅђрѕѕрѕЮ
­ЪЎј­ЪЈЙ	рѕ░рІЇ ріЦрІерї«ріИрЇА рѕўрѕЃріерѕѕріЏ рЅђрѕІ рІФрѕѕ рІерЅєрІ│ рЅђрѕѕрѕЮ
­ЪЎј­ЪЈ┐	рІерѕџрї«рѕЁ рѕ░рІЇ: рїЦрЅЂрѕГ рІерЅєрІ│ рЅђрѕѕрѕЮ
­ЪЎјРђЇРЎѓ№ИЈ	рѕ░рІЇ ріЦрІерї«ріИ
­ЪЎјРђЇРЎѓ	рѕ░рІЇ ріЦрІерї«ріИ
­ЪЎј­ЪЈ╗РђЇРЎѓ№ИЈ	рѕ░рІЇ pouting: рЅђрѕІрѕЇ рІерЅєрІ│ рЅЃріЊ
­ЪЎј­ЪЈ╗РђЇРЎѓ	рѕ░рІЇ pouting: рЅђрѕІрѕЇ рІерЅєрІ│ рЅЃріЊ
­ЪЎј­ЪЈ╝РђЇРЎѓ№ИЈ	рѕ░рІЇ рѕЏрЇЇрѕ░рѕ╗рЇА рѕўрѕЃріерѕѕріЏ рЅђрѕІ рІФрѕѕ рІерЅєрІ│ рЅђрѕѕрѕЮ
­ЪЎј­ЪЈ╝РђЇРЎѓ	рѕ░рІЇ рѕЏрЇЇрѕ░рѕ╗рЇА рѕўрѕЃріерѕѕріЏ рЅђрѕІ рІФрѕѕ рІерЅєрІ│ рЅђрѕѕрѕЮ
­ЪЎј­ЪЈйРђЇРЎѓ№ИЈ	рѕ░рІЇ pouting: рѕўрѕЃріерѕѕріЏ рІерЅєрІ│ рЅђрѕѕрѕЮ
­ЪЎј­ЪЈйРђЇРЎѓ	рѕ░рІЇ pouting: рѕўрѕЃріерѕѕріЏ рІерЅєрІ│ рЅђрѕѕрѕЮ
­ЪЎј­ЪЈЙРђЇРЎѓ№ИЈ	рѕ░рІЇ рѕЏрЇЇрѕ░рѕ╗: рѕўрѕЃріерѕѕріЏ-рїЦрЅЂрѕГ рІерЅєрІ│ рЅђрѕѕрѕЮ
­ЪЎј­ЪЈЙРђЇРЎѓ	рѕ░рІЇ ріЦрІФрЇѕрѕ░рѕ▒рЇА рѕўрѕЃріерѕѕріЏ рЅђрѕІ рІФрѕѕ рІерЅєрІ│ рЅђрѕѕрѕЮ
­ЪЎј­ЪЈ┐РђЇРЎѓ№ИЈ	рѕ░рІЇ ріЦрІерї«ріИ: рїЦрЅЂрѕГ рІерЅєрІ│ рЅђрѕѕрѕЮ
­ЪЎј­ЪЈ┐РђЇРЎѓ	рѕ░рІЇ ріЦрІерї«ріИ: рїЦрЅЂрѕГ рІерЅєрІ│ рЅђрѕѕрѕЮ
­ЪЎјРђЇРЎђ№ИЈ	рѕ┤рЅх ріЦрІерї«ріИрЅй
­ЪЎјРђЇРЎђ	рѕ┤рЅх ріЦрІерї«ріИрЅй
­ЪЎј­ЪЈ╗РђЇРЎђ№ИЈ	рѕ┤рЅх рїЕріИрЅх: рЅђрѕІрѕЇ рІерЅєрІ│ рЅђрѕѕрѕЮ
­ЪЎј­ЪЈ╗РђЇРЎђ	рѕ┤рЅх рїЕріИрЅх: рЅђрѕІрѕЇ рІерЅєрІ│ рЅђрѕѕрѕЮ
­ЪЎј­ЪЈ╝РђЇРЎђ№ИЈ	рѕ┤рЅх рїЕріИрЅх: рѕўрѕЃріерѕѕріЏ рЅђрѕІ рІФрѕѕ рІерЅєрІ│ рЅђрѕѕрѕЮ
­ЪЎј­ЪЈ╝РђЇРЎђ	рѕ┤рЅх рїЕріИрЅх: рѕўрѕЃріерѕѕріЏ рЅђрѕІ рІФрѕѕ рІерЅєрІ│ рЅђрѕѕрѕЮ
­ЪЎј­ЪЈйРђЇРЎђ№ИЈ	рѕ┤рЅх рїЕріИрЅх: рѕўрѕЃріерѕѕріЏ рІерЅєрІ│ рЅђрѕѕрѕЮ
­ЪЎј­ЪЈйРђЇРЎђ	рѕ┤рЅх рїЕріИрЅх: рѕўрѕЃріерѕѕріЏ рІерЅєрІ│ рЅђрѕѕрѕЮ
­ЪЎј­ЪЈЙРђЇРЎђ№ИЈ	рѕ┤рЅх рїЕріИрЅх: рѕўрѕЃріерѕѕріЏ-рїЦрЅЂрѕГ рІерЅєрІ│ рЅђрѕѕрѕЮ
­ЪЎј­ЪЈЙРђЇРЎђ	рѕ┤рЅх рїЕріИрЅх: рѕўрѕЃріерѕѕріЏ-рїЦрЅЂрѕГ рІерЅєрІ│ рЅђрѕѕрѕЮ
­ЪЎј­ЪЈ┐РђЇРЎђ№ИЈ	рѕ┤рЅх рїЕріИрЅх: рїЦрЅЂрѕГ рІерЅєрІ│ рЅђрѕѕрѕЮ
­ЪЎј­ЪЈ┐РђЇРЎђ	рѕ┤рЅх рїЕріИрЅх: рїЦрЅЂрѕГ рІерЅєрІ│ рЅђрѕѕрѕЮ
­ЪЎЁ	рѕ░рІЇ NO
­ЪЎЁ­ЪЈ╗	рІерѕѕрѕЮ рІерѕџрѕЇ рѕЮрѕЇріГрЅх рІФрѕѕрІЇ рѕ░рІЇрЇА рЅђрѕІрѕЇ рІерЅєрІ│ рЅђрѕѕрѕЮ
­ЪЎЁ­ЪЈ╝	рѕЮрѕЇріГрЅх рІерѕџрІФрІ░рѕГрїЇ рѕ░рІЇ рІерѕѕрѕЮрЇА рѕўрѕЃріерѕѕріЏ рЅђрѕІ рІФрѕѕ рІерЅєрІ│ рЅђрѕѕрѕЮ
­ЪЎЁ­ЪЈй	рѕЮрѕЇріГрЅх рІерѕџрІФрІ░рѕГрїЇ рѕ░рІЇ рІерѕѕрѕЮрЇА рѕўрѕЃріерѕѕріЏ рІерЅєрІ│ рЅђрѕѕрѕЮ
­ЪЎЁ­ЪЈЙ	рѕЮрѕЇріГрЅх рІерѕџрІФрІ░рѕГрїЇ рѕ░рІЇ рІерѕѕрѕЮрЇА рѕўрѕЃріерѕѕріЏ рЅђрѕІ рІФрѕѕ рІерЅєрІ│ рЅђрѕѕрѕЮ
­ЪЎЁ­ЪЈ┐	рІерѕѕрѕЮ рІерѕџрѕЇ рѕЮрѕЇріГрЅх рІФрѕѕрІЇ рѕ░рІЇрЇА рїЦрЅЂрѕГ рІерЅєрІ│ рЅђрѕѕрѕЮ
­ЪЎЁРђЇРЎѓ№ИЈ	рѕ░рІЇ NO
­ЪЎЁРђЇРЎѓ	рѕ░рІЇ NO
­ЪЎЁ­ЪЈ╗РђЇРЎѓ№ИЈ	рѕ░рІЇ NO: рЅђрѕІрѕЇ рІерЅєрІ│ рЅђрѕѕрѕЮ ріЦрІФрѕўрѕІріерЅ░
­ЪЎЁ­ЪЈ╗РђЇРЎѓ	рѕ░рІЇ NO: рЅђрѕІрѕЇ рІерЅєрІ│ рЅђрѕѕрѕЮ ріЦрІФрѕўрѕІріерЅ░
­ЪЎЁ­ЪЈ╝РђЇРЎѓ№ИЈ	рѕ░рІЇ NO: рѕўрѕЃріерѕѕріЏ рЅђрѕІ рІФрѕѕ рІерЅєрІ│ рЅђрѕѕрѕЮ
­ЪЎЁ­ЪЈ╝РђЇРЎѓ	рѕ░рІЇ NO: рѕўрѕЃріерѕѕріЏ рЅђрѕІ рІФрѕѕ рІерЅєрІ│ рЅђрѕѕрѕЮ
­ЪЎЁ­ЪЈйРђЇРЎѓ№ИЈ	рІѕріЋрІх рѕЮрѕЇріГрЅх ріарІГ: рѕўрѕЃріерѕѕріЏ рІерЅєрІ│ рЅђрѕѕрѕЮ
­ЪЎЁ­ЪЈйРђЇРЎѓ	рІѕріЋрІх рѕЮрѕЇріГрЅх ріарІГ: рѕўрѕЃріерѕѕріЏ рІерЅєрІ│ рЅђрѕѕрѕЮ
­ЪЎЁ­ЪЈЙРђЇРЎѓ№ИЈ	рѕ░рІЇ NO: рѕўрѕЃріерѕѕріЏ рЅђрѕІ рІФрѕѕ рІерЅєрІ│ рЅђрѕѕрѕЮ
­ЪЎЁ­ЪЈЙРђЇРЎѓ	рѕ░рІЇ NO: рѕўрѕЃріерѕѕріЏ рЅђрѕІ рІФрѕѕ рІерЅєрІ│ рЅђрѕѕрѕЮ
­ЪЎЁ­ЪЈ┐РђЇРЎѓ№ИЈ	рѕ░рІЇ NO: рїЦрЅЂрѕГ рІерЅєрІ│ рЅђрѕѕрѕЮ
­ЪЎЁ­ЪЈ┐РђЇРЎѓ	рѕ░рІЇ NO: рїЦрЅЂрѕГ рІерЅєрІ│ рЅђрѕѕрѕЮ
­ЪЎЁРђЇРЎђ№ИЈ	рѕ┤рЅх рѕЮрѕЇріГрЅх NO
­ЪЎЁРђЇРЎђ	рѕ┤рЅх рѕЮрѕЇріГрЅх NO
­ЪЎЁ­ЪЈ╗РђЇРЎђ№ИЈ	рѕ┤рЅх рЅарѕЮрѕЇріГрЅх NO: рЅђрѕІрѕЇ рІерЅєрІ│ рЅђрѕѕрѕЮ
­ЪЎЁ­ЪЈ╗РђЇРЎђ	рѕ┤рЅх рЅарѕЮрѕЇріГрЅх NO: рЅђрѕІрѕЇ рІерЅєрІ│ рЅђрѕѕрѕЮ
­ЪЎЁ­ЪЈ╝РђЇРЎђ№ИЈ	рѕ┤рЅх рЅарѕЮрѕЇріГрЅх NO: рѕўрѕЃріерѕѕріЏ рЅђрѕІ рІФрѕѕ рІерЅєрІ│ рЅђрѕѕрѕЮ
­ЪЎЁ­ЪЈ╝РђЇРЎђ	рѕ┤рЅх рЅарѕЮрѕЇріГрЅх NO: рѕўрѕЃріерѕѕріЏ рЅђрѕІ рІФрѕѕ рІерЅєрІ│ рЅђрѕѕрѕЮ
­ЪЎЁ­ЪЈйРђЇРЎђ№ИЈ	рѕ┤рЅх рѕЮрѕЇріГрЅх NO: рѕўрѕЃріерѕѕріЏ рІерЅєрІ│ рЅђрѕѕрѕЮ
­ЪЎЁ­ЪЈйРђЇРЎђ	рѕ┤рЅх рѕЮрѕЇріГрЅх NO: рѕўрѕЃріерѕѕріЏ рІерЅєрІ│ рЅђрѕѕрѕЮ
­ЪЎЁ­ЪЈЙРђЇРЎђ№ИЈ	рѕ┤рЅх рѕЮрѕЇріГрЅх NO: рѕўрѕЃріерѕѕріЏ рЅђрѕІ рІФрѕѕ рІерЅєрІ│ рЅђрѕѕрѕЮ
­ЪЎЁ­ЪЈЙРђЇРЎђ	рѕ┤рЅх рѕЮрѕЇріГрЅх NO: рѕўрѕЃріерѕѕріЏ рЅђрѕІ рІФрѕѕ рІерЅєрІ│ рЅђрѕѕрѕЮ
­ЪЎЁ­ЪЈ┐РђЇРЎђ№ИЈ	рѕ┤рЅх рѕЮрѕЇріГрЅх NO: рїЦрЅЂрѕГ рІерЅєрІ│ рЅђрѕѕрѕЮ
­ЪЎЁ­ЪЈ┐РђЇРЎђ	рѕ┤рЅх рѕЮрѕЇріГрЅх NO: рїЦрЅЂрѕГ рІерЅєрІ│ рЅђрѕѕрѕЮ
­ЪЎє	ріЦрѕ║ рІерѕџрѕЇ рѕЮрѕЇріГрЅх рІФрѕѕрІЇ рѕ░рІЇ
­ЪЎє­ЪЈ╗	ріЦрѕ║ріЋ рІерѕџрІФрѕ│рІГ рѕ░рІЇрЇА рЅђрѕІрѕЇ рІерЅєрІ│ рЅђрѕѕрѕЮ
­ЪЎє­ЪЈ╝	ріЦрѕ║ріЋ рІерѕџрІФрѕ│рІГ рѕ░рІЇрЇА рѕўрѕЃріерѕѕріЏ рЅђрѕІ рІФрѕѕ рІерЅєрІ│ рЅђрѕѕрѕЮ
­ЪЎє­ЪЈй	ріЦрѕ║ рІерѕџрѕЇ рѕЮрѕЇріГрЅх рІФрѕѕрІЇ рѕ░рІЇрЇА рѕўрѕЃріерѕѕріЏ рІерЅєрІ│ рЅђрѕѕрѕЮ
­ЪЎє­ЪЈЙ	ріЦрѕ║ріЋ рІерѕџрІФрѕ│рІГ рѕ░рІЇрЇА рѕўрѕЃріерѕѕріЏ рЅђрѕІ рІФрѕѕ рІерЅєрІ│ рЅђрѕѕрѕЮ
­ЪЎє­ЪЈ┐	ріЦрѕ║ рІерѕџрѕЇ рѕЮрѕЇріГрЅх рІФрѕѕрІЇ рѕ░рІЇрЇА рїЦрЅЂрѕГ рІерЅєрІ│ рЅђрѕѕрѕЮ
­ЪЎєРђЇРЎѓ№ИЈ	рѕ░рІЇрІг ріЦрѕ║ріЋ ріЦрІФрѕ│рІе
­ЪЎєРђЇРЎѓ	рѕ░рІЇрІг ріЦрѕ║ріЋ ріЦрІФрѕ│рІе
­ЪЎє­ЪЈ╗РђЇРЎѓ№ИЈ	рѕ░рІЇ ріЦрѕ║ріЋ ріЦрІФрѕўрѕІріерЅ░рЇА рЅђрѕІрѕЇ рІерЅєрІ│ рЅђрѕѕрѕЮ
­ЪЎє­ЪЈ╗РђЇРЎѓ	рѕ░рІЇ ріЦрѕ║ріЋ ріЦрІФрѕўрѕІріерЅ░рЇА рЅђрѕІрѕЇ рІерЅєрІ│ рЅђрѕѕрѕЮ
­ЪЎє­ЪЈ╝РђЇРЎѓ№ИЈ	рѕ░рІЇ ріЦрѕ║ріЋ ріЦрІФрѕўрѕІріерЅ░рЇА рѕўрѕЃріерѕѕріЏ рЅђрѕІ рІФрѕѕ рІерЅєрІ│ рЅђрѕѕрѕЮ
­ЪЎє­ЪЈ╝РђЇРЎѓ	рѕ░рІЇ ріЦрѕ║ріЋ ріЦрІФрѕўрѕІріерЅ░рЇА рѕўрѕЃріерѕѕріЏ рЅђрѕІ рІФрѕѕ рІерЅєрІ│ рЅђрѕѕрѕЮ
­ЪЎє­ЪЈйРђЇРЎѓ№ИЈ	рѕ░рІЇ ріЦрѕ║ріЋ ріЦрІФрѕўрѕІріерЅ░рЇА рѕўрѕЃріерѕѕріЏ рІерЅєрІ│ рЅђрѕѕрѕЮ
­ЪЎє­ЪЈйРђЇРЎѓ	рѕ░рІЇ ріЦрѕ║ріЋ ріЦрІФрѕўрѕІріерЅ░рЇА рѕўрѕЃріерѕѕріЏ рІерЅєрІ│ рЅђрѕѕрѕЮ
­ЪЎє­ЪЈЙРђЇРЎѓ№ИЈ	рѕ░рІЇ ріЦрѕ║ріЋ ріЦрІФрѕўрѕІріерЅ░рЇА рѕўрѕЃріерѕѕріЏ рЅђрѕІ рІФрѕѕ рІерЅєрІ│ рЅђрѕѕрѕЮ
­ЪЎє­ЪЈЙРђЇРЎѓ	рѕ░рІЇ ріЦрѕ║ріЋ ріЦрІФрѕўрѕІріерЅ░рЇА рѕўрѕЃріерѕѕріЏ рЅђрѕІ рІФрѕѕ рІерЅєрІ│ рЅђрѕѕрѕЮ
­ЪЎє­ЪЈ┐РђЇРЎѓ№ИЈ	рѕ░рІЇ ріЦрѕ║ріЋ ріЦрІФрѕўрѕІріерЅ░рЇА рїЦрЅЂрѕГ рІерЅєрІ│ рЅђрѕѕрѕЮ
­ЪЎє­ЪЈ┐РђЇРЎѓ	рѕ░рІЇ ріЦрѕ║ріЋ ріЦрІФрѕўрѕІріерЅ░рЇА рїЦрЅЂрѕГ рІерЅєрІ│ рЅђрѕѕрѕЮ
­ЪЎєРђЇРЎђ№ИЈ	рѕ┤рЅх ріЦрѕ║ рЅарѕЮрѕЇріГрЅх ріЦрІерЅ░ріЊрїѕрѕерЅй ріљрІЇрЇб
­ЪЎєРђЇРЎђ	рѕ┤рЅх ріЦрѕ║ рЅарѕЮрѕЇріГрЅх ріЦрІерЅ░ріЊрїѕрѕерЅй ріљрІЇрЇб
­ЪЎє­ЪЈ╗РђЇРЎђ№ИЈ	рѕ┤рЅх ріЦрѕ║ріЋ рЅарѕЮрѕЇріГрЅх ріЦрІФрѕ│рІерЅйрЇА рЅђрѕІрѕЇ рІерЅєрІ│ рЅђрѕѕрѕЮ
­ЪЎє­ЪЈ╗РђЇРЎђ	рѕ┤рЅх ріЦрѕ║ріЋ рЅарѕЮрѕЇріГрЅх ріЦрІФрѕ│рІерЅйрЇА рЅђрѕІрѕЇ рІерЅєрІ│ рЅђрѕѕрѕЮ
­ЪЎє­ЪЈ╝РђЇРЎђ№ИЈ	рѕ┤рЅх ріЦрѕ║ріЋ рЅарѕЮрѕЇріГрЅх ріЦрІФрѕ│рІерЅйрЇА рѕўрѕЃріерѕѕріЏ рЅђрѕІ рІФрѕѕ рІерЅєрІ│ рЅђрѕѕрѕЮ
­ЪЎє­ЪЈ╝РђЇРЎђ	рѕ┤рЅх ріЦрѕ║ріЋ рЅарѕЮрѕЇріГрЅх ріЦрІФрѕ│рІерЅйрЇА рѕўрѕЃріерѕѕріЏ рЅђрѕІ рІФрѕѕ рІерЅєрІ│ рЅђрѕѕрѕЮ
­ЪЎє­ЪЈйРђЇРЎђ№ИЈ	рѕ┤рЅх ріЦрѕ║ріЋ рЅарѕЮрѕЇріГрЅх ріЦрІФрѕ│рІерЅйрЇА рѕўрѕЃріерѕѕріЏ рІерЅєрІ│ рЅђрѕѕрѕЮ
­ЪЎє­ЪЈйРђЇРЎђ	рѕ┤рЅх ріЦрѕ║ріЋ рЅарѕЮрѕЇріГрЅх ріЦрІФрѕ│рІерЅйрЇА рѕўрѕЃріерѕѕріЏ рІерЅєрІ│ рЅђрѕѕрѕЮ
­ЪЎє­ЪЈЙРђЇРЎђ№ИЈ	рѕ┤рЅх ріЦрѕ║ріЋ рЅарѕЮрѕЇріГрЅх ріЦрІФрѕ│рІерЅйрЇА рѕўрѕЃріерѕѕріЏ рЅђрѕІ рІФрѕѕ рІерЅєрІ│ рЅђрѕѕрѕЮ
­ЪЎє­ЪЈЙРђЇРЎђ	рѕ┤рЅх ріЦрѕ║ріЋ рЅарѕЮрѕЇріГрЅх ріЦрІФрѕ│рІерЅйрЇА рѕўрѕЃріерѕѕріЏ рЅђрѕІ рІФрѕѕ рІерЅєрІ│ рЅђрѕѕрѕЮ
­ЪЎє­ЪЈ┐РђЇРЎђ№ИЈ	рѕ┤рЅх ріЦрѕ║ріЋ рЅарѕЮрѕЇріГрЅх ріЦрІФрѕ│рІерЅйрЇА рїЦрЅЂрѕГ рІерЅєрІ│ рЅђрѕѕрѕЮ
­ЪЎє­ЪЈ┐РђЇРЎђ	рѕ┤рЅх ріЦрѕ║ріЋ рЅарѕЮрѕЇріГрЅх ріЦрІФрѕ│рІерЅйрЇА рїЦрЅЂрѕГ рІерЅєрІ│ рЅђрѕѕрѕЮ
­ЪњЂ	ріаріЋрІх рѕ░рІЇ ріЦрїЂріЋ рѕ▓рїГріЋ
­ЪњЂ­ЪЈ╗	рѕ░рІЇ ріЦрїЂріЋ рѕ▓рѕ░рїЦрЇА рЅђрѕІрѕЇ рІерЅєрІ│ рЅђрѕѕрѕЮ
­ЪњЂ­ЪЈ╝	рѕ░рІЇ ріЦрїЂріЋ ріЦрІерїарЅєрѕўрЇА рѕўрѕЃріерѕѕріЏ рЅђрѕІ рІФрѕѕ рІерЅєрІ│ рЅђрѕѕрѕЮ
­ЪњЂ­ЪЈй	рѕ░рІЇ ріЦрїЂріЋ ріЦрІерїарЅєрѕўрЇА рѕўрѕЃріерѕѕріЏ рІерЅєрІ│ рЅђрѕѕрѕЮ
­ЪњЂ­ЪЈЙ	рѕ░рІЇ ріЦрїЂріЋ ріЦрІерїарЅєрѕўрЇА рѕўрѕЃріерѕѕріЏ рЅђрѕІ рІФрѕѕ рІерЅєрІ│ рЅђрѕѕрѕЮ
­ЪњЂ­ЪЈ┐	рѕ░рІЇ ріЦрїЂріЋ ріЦрІерїарЅєрѕўрЇА рїЦрЅЂрѕГ рІерЅєрІ│ рЅђрѕѕрѕЮ
­ЪњЂРђЇРЎѓ№ИЈ	рѕ░рІЇ ріЦрїЂріЋ рѕўрѕЮрЅ│рЅх
­ЪњЂРђЇРЎѓ	рѕ░рІЇ ріЦрїЂріЋ рѕўрѕЮрЅ│рЅх
­ЪњЂ­ЪЈ╗РђЇРЎѓ№ИЈ	рѕ░рІЇ ріЦрїЂріЋ рѕўрѕЮрЅ│рЅхрЇА рЅђрѕІрѕЇ рІерЅєрІ│ рЅђрѕѕрѕЮ
­ЪњЂ­ЪЈ╗РђЇРЎѓ	рѕ░рІЇ ріЦрїЂріЋ рѕўрѕЮрЅ│рЅхрЇА рЅђрѕІрѕЇ рІерЅєрІ│ рЅђрѕѕрѕЮ
­ЪњЂ­ЪЈ╝РђЇРЎѓ№ИЈ	рѕ░рІЇ ріЦрїЂріЋ рѕўрѕЮрЅ│рЅхрЇА рѕўрѕЃріерѕѕріЏ рЅђрѕІ рІФрѕѕ рІерЅєрІ│ рЅђрѕѕрѕЮ
­ЪњЂ­ЪЈ╝РђЇРЎѓ	рѕ░рІЇ ріЦрїЂріЋ рѕўрѕЮрЅ│рЅхрЇА рѕўрѕЃріерѕѕріЏ рЅђрѕІ рІФрѕѕ рІерЅєрІ│ рЅђрѕѕрѕЮ
­ЪњЂ­ЪЈйРђЇРЎѓ№ИЈ	рѕ░рІЇ рѕўрѕЮрЅ│рЅх ріЦрїЁ: рѕўрѕЃріерѕѕріЏ рІерЅєрІ│ рЅђрѕѕрѕЮ
­ЪњЂ­ЪЈйРђЇРЎѓ	рѕ░рІЇ рѕўрѕЮрЅ│рЅх ріЦрїЁ: рѕўрѕЃріерѕѕріЏ рІерЅєрІ│ рЅђрѕѕрѕЮ
­ЪњЂ­ЪЈЙРђЇРЎѓ№ИЈ	рѕ░рІЇ ріЦрїЂріЋ рѕўрѕЮрЅ│рЅхрЇА рѕўрѕЃріерѕѕріЏ рЅђрѕІ рІФрѕѕ рІерЅєрІ│ рЅђрѕѕрѕЮ
­ЪњЂ­ЪЈЙРђЇРЎѓ	рѕ░рІЇ ріЦрїЂріЋ рѕўрѕЮрЅ│рЅхрЇА рѕўрѕЃріерѕѕріЏ рЅђрѕІ рІФрѕѕ рІерЅєрІ│ рЅђрѕѕрѕЮ
­ЪњЂ­ЪЈ┐РђЇРЎѓ№ИЈ	рѕ░рІЇ ріЦрїЂріЋ рѕўрѕЮрЅ│рЅхрЇА рїЦрЅЂрѕГ рІерЅєрІ│ рЅђрѕѕрѕЮ
­ЪњЂ­ЪЈ┐РђЇРЎѓ	рѕ░рІЇ ріЦрїЂріЋ рѕўрѕЮрЅ│рЅхрЇА рїЦрЅЂрѕГ рІерЅєрІ│ рЅђрѕѕрѕЮ
­ЪњЂРђЇРЎђ№ИЈ	ріаріЋрІ▓рЅх рѕ┤рЅх ріЦрїЄріЋ рѕхрЅхрїГріЋ
­ЪњЂРђЇРЎђ	ріаріЋрІ▓рЅх рѕ┤рЅх ріЦрїЄріЋ рѕхрЅхрїГріЋ
­ЪњЂ­ЪЈ╗РђЇРЎђ№ИЈ	рѕ┤рЅх ріЦрїЄріЋ рѕхрЅхрѕ░рїЦрЇА рЅђрѕІрѕЇ рІерЅєрІ│ рЅђрѕѕрѕЮ
­ЪњЂ­ЪЈ╗РђЇРЎђ	рѕ┤рЅх ріЦрїЄріЋ рѕхрЅхрѕ░рїЦрЇА рЅђрѕІрѕЇ рІерЅєрІ│ рЅђрѕѕрѕЮ
­ЪњЂ­ЪЈ╝РђЇРЎђ№ИЈ	рѕ┤рЅх ріЦрїЄріЋ рѕхрЅхрѕ░рїЦрЇА рѕўрѕЃріерѕѕріЏ рЅђрѕІ рІФрѕѕ рІерЅєрІ│ рЅђрѕѕрѕЮ
­ЪњЂ­ЪЈ╝РђЇРЎђ	рѕ┤рЅх ріЦрїЄріЋ рѕхрЅхрѕ░рїЦрЇА рѕўрѕЃріерѕѕріЏ рЅђрѕІ рІФрѕѕ рІерЅєрІ│ рЅђрѕѕрѕЮ
­ЪњЂ­ЪЈйРђЇРЎђ№ИЈ	рѕ┤рЅх рѕўрѕЮрЅ│рЅх ріЦрїЁ: рѕўрѕЃріерѕѕріЏ рІерЅєрІ│ рЅђрѕѕрѕЮ
­ЪњЂ­ЪЈйРђЇРЎђ	рѕ┤рЅх рѕўрѕЮрЅ│рЅх ріЦрїЁ: рѕўрѕЃріерѕѕріЏ рІерЅєрІ│ рЅђрѕѕрѕЮ
­ЪњЂ­ЪЈЙРђЇРЎђ№ИЈ	рѕ┤рЅх ріЦрїЄріЋ рѕхрЅхрѕ░рїЦрЇА рѕўрѕЃріерѕѕріЏ рЅђрѕІ рІФрѕѕ рІерЅєрІ│ рЅђрѕѕрѕЮ
­ЪњЂ­ЪЈЙРђЇРЎђ	рѕ┤рЅх ріЦрїЄріЋ рѕхрЅхрѕ░рїЦрЇА рѕўрѕЃріерѕѕріЏ рЅђрѕІ рІФрѕѕ рІерЅєрІ│ рЅђрѕѕрѕЮ
­ЪњЂ­ЪЈ┐РђЇРЎђ№ИЈ	рѕ┤рЅх ріЦрїЄріЋ рІерѕЮрЅхрѕ░рїЦ: рїЦрЅЂрѕГ рІерЅєрІ│ рЅђрѕѕрѕЮ
­ЪњЂ­ЪЈ┐РђЇРЎђ	рѕ┤рЅх ріЦрїЄріЋ рІерѕЮрЅхрѕ░рїЦ: рїЦрЅЂрѕГ рІерЅєрІ│ рЅђрѕѕрѕЮ
­ЪЎІ	ріЦрїЂріЋ рІерѕџрІФріљрѕ│ рѕ░рІЇ
­ЪЎІ­ЪЈ╗	ріЦрїЂріЋ рІерѕџрІФріљрѕ│ рѕ░рІЇрЇА рЅђрѕІрѕЇ рІерЅєрІ│ рЅђрѕѕрѕЮ
­ЪЎІ­ЪЈ╝	ріЦрїЂріЋ рІерѕџрІФріљрѕ│ рѕ░рІЇрЇА рѕўрѕЃріерѕѕріЏ рЅђрѕІ рІФрѕѕ рІерЅєрІ│ рЅђрѕѕрѕЮ
­ЪЎІ­ЪЈй	ріЦрїЁ рІерѕџрІФріљрѕ│ рѕ░рІЇрЇА рѕўрѕЃріерѕѕріЏ рІерЅєрІ│ рЅђрѕѕрѕЮ
­ЪЎІ­ЪЈЙ	ріЦрїЂріЋ рІерѕџрІФріљрѕ│ рѕ░рІЇрЇА рѕўрѕЃріерѕѕріЏ рЅђрѕІ рІФрѕѕ рІерЅєрІ│ рЅђрѕѕрѕЮ
­ЪЎІ­ЪЈ┐	ріЦрїЂріЋ рІерѕџрІФріљрѕ│ рѕ░рІЇ: рїЦрЅЂрѕГ рІерЅєрІ│ рЅђрѕѕрѕЮ
­ЪЎІРђЇРЎѓ№ИЈ	ріЦрїЂріЋ рІерѕџрІФріљрѕ│ рѕ░рІЇ
­ЪЎІРђЇРЎѓ	ріЦрїЂріЋ рІерѕџрІФріљрѕ│ рѕ░рІЇ
­ЪЎІ­ЪЈ╗РђЇРЎѓ№ИЈ	рѕ░рІЇ ріЦрїЂріЋ рѕ▓рІФріљрѕ│рЇА рЅђрѕІрѕЇ рІерЅєрІ│ рЅђрѕѕрѕЮ
­ЪЎІ­ЪЈ╗РђЇРЎѓ	рѕ░рІЇ ріЦрїЂріЋ рѕ▓рІФріљрѕ│рЇА рЅђрѕІрѕЇ рІерЅєрІ│ рЅђрѕѕрѕЮ
­ЪЎІ­ЪЈ╝РђЇРЎѓ№ИЈ	ріЦрїЂріЋ рІерѕџрІФріљрѕ│ рѕ░рІЇрЇА рѕўрѕЃріерѕѕріЏ рЅђрѕІ рІФрѕѕ рІерЅєрІ│ рЅђрѕѕрѕЮ
­ЪЎІ­ЪЈ╝РђЇРЎѓ	ріЦрїЂріЋ рІерѕџрІФріљрѕ│ рѕ░рІЇрЇА рѕўрѕЃріерѕѕріЏ рЅђрѕІ рІФрѕѕ рІерЅєрІ│ рЅђрѕѕрѕЮ
­ЪЎІ­ЪЈйРђЇРЎѓ№ИЈ	ріЦрїЂріЋ рІерѕџрІФріљрѕ│ рѕ░рІЇ: рѕўрѕЃріерѕѕріЏ рІерЅєрІ│ рЅђрѕѕрѕЮ
­ЪЎІ­ЪЈйРђЇРЎѓ	ріЦрїЂріЋ рІерѕџрІФріљрѕ│ рѕ░рІЇ: рѕўрѕЃріерѕѕріЏ рІерЅєрІ│ рЅђрѕѕрѕЮ
­ЪЎІ­ЪЈЙРђЇРЎѓ№ИЈ	ріЦрїЂріЋ рІерѕџрІФріљрѕ│ рѕ░рІЇрЇА рѕўрѕЃріерѕѕріЏ рЅђрѕІ рІФрѕѕ рІерЅєрІ│ рЅђрѕѕрѕЮ
­ЪЎІ­ЪЈЙРђЇРЎѓ	ріЦрїЂріЋ рІерѕџрІФріљрѕ│ рѕ░рІЇрЇА рѕўрѕЃріерѕѕріЏ рЅђрѕІ рІФрѕѕ рІерЅєрІ│ рЅђрѕѕрѕЮ
­ЪЎІ­ЪЈ┐РђЇРЎѓ№ИЈ	ріЦрїЂріЋ рІерѕџрІФріљрѕ│ рѕ░рІЇ: рїЦрЅЂрѕГ рІерЅєрІ│ рЅђрѕѕрѕЮ
­ЪЎІ­ЪЈ┐РђЇРЎѓ	ріЦрїЂріЋ рІерѕџрІФріљрѕ│ рѕ░рІЇ: рїЦрЅЂрѕГ рІерЅєрІ│ рЅђрѕѕрѕЮ
­ЪЎІРђЇРЎђ№ИЈ	рѕ┤рЅх ріЦрїЄріЋ рЅарѕЏріЋрѕ│рЅх
­ЪЎІРђЇРЎђ	рѕ┤рЅх ріЦрїЄріЋ рЅарѕЏріЋрѕ│рЅх
­ЪЎІ­ЪЈ╗РђЇРЎђ№ИЈ	рѕ┤рЅх ріЦрїЄріЋ рЅарѕЏріЋрѕ│рЅх: рЅђрѕІрѕЇ рІерЅєрІ│ рЅђрѕѕрѕЮ
­ЪЎІ­ЪЈ╗РђЇРЎђ	рѕ┤рЅх ріЦрїЄріЋ рЅарѕЏріЋрѕ│рЅх: рЅђрѕІрѕЇ рІерЅєрІ│ рЅђрѕѕрѕЮ
­ЪЎІ­ЪЈ╝РђЇРЎђ№ИЈ	рѕ┤рЅх ріЦрїЄріЋ рІерѕЮрЅ│ріљрѕ│рЇА рѕўрѕЃріерѕѕріЏ рЅђрѕІ рІФрѕѕ рІерЅєрІ│ рЅђрѕѕрѕЮ
­ЪЎІ­ЪЈ╝РђЇРЎђ	рѕ┤рЅх ріЦрїЄріЋ рІерѕЮрЅ│ріљрѕ│рЇА рѕўрѕЃріерѕѕріЏ рЅђрѕІ рІФрѕѕ рІерЅєрІ│ рЅђрѕѕрѕЮ
­ЪЎІ­ЪЈйРђЇРЎђ№ИЈ	рѕ┤рЅх ріЦрїЄріЋ рІерѕЮрЅ│ріљрѕ│: рѕўрѕЃріерѕѕріЏ рІерЅєрІ│ рЅђрѕѕрѕЮ
­ЪЎІ­ЪЈйРђЇРЎђ	рѕ┤рЅх ріЦрїЄріЋ рІерѕЮрЅ│ріљрѕ│: рѕўрѕЃріерѕѕріЏ рІерЅєрІ│ рЅђрѕѕрѕЮ
­ЪЎІ­ЪЈЙРђЇРЎђ№ИЈ	рѕ┤рЅх ріЦрїЄріЋ рІерѕЮрЅ│ріљрѕ│рЇА рѕўрѕЃріерѕѕріЏ рЅђрѕІ рІФрѕѕ рІерЅєрІ│ рЅђрѕѕрѕЮ
­ЪЎІ­ЪЈЙРђЇРЎђ	рѕ┤рЅх ріЦрїЄріЋ рІерѕЮрЅ│ріљрѕ│рЇА рѕўрѕЃріерѕѕріЏ рЅђрѕІ рІФрѕѕ рІерЅєрІ│ рЅђрѕѕрѕЮ
­ЪЎІ­ЪЈ┐РђЇРЎђ№ИЈ	рѕ┤рЅх ріЦрїЄріЋ рІерѕЮрЅ│ріљрѕ│: рїЦрЅЂрѕГ рІерЅєрІ│ рЅђрѕѕрѕЮ
­ЪЎІ­ЪЈ┐РђЇРЎђ	рѕ┤рЅх ріЦрїЄріЋ рІерѕЮрЅ│ріљрѕ│: рїЦрЅЂрѕГ рІерЅєрІ│ рЅђрѕѕрѕЮ
­ЪЎЄ	рѕ░рІЇ рѕ░рїѕрІ░
­ЪЎЄ­ЪЈ╗	рІерѕџрѕ░рїЇрІх рѕ░рІЇрЇА рЅђрѕІрѕЇ рІерЅєрІ│ рЅђрѕѕрѕЮ
­ЪЎЄ­ЪЈ╝	рІерѕџрѕ░рїЇрІх рѕ░рІЇрЇА рѕўрѕЃріерѕѕріЏ рЅђрѕІ рІФрѕѕ рІерЅєрІ│ рЅђрѕѕрѕЮ
­ЪЎЄ­ЪЈй	рІерѕџрѕ░рїЇрІх рѕ░рІЇрЇА рѕўрѕЃріерѕѕріЏ рІерЅєрІ│ рЅђрѕѕрѕЮ
­ЪЎЄ­ЪЈЙ	рІерѕџрѕ░рїЇрІх рѕ░рІЇрЇА рѕўрѕЃріерѕѕріЏ рЅђрѕІ рІФрѕѕ рІерЅєрІ│ рЅђрѕѕрѕЮ
­ЪЎЄ­ЪЈ┐	рІерѕџрѕ░рїЇрІх рѕ░рІЇрЇА рїЦрЅЂрѕГ рІерЅєрІ│ рЅђрѕѕрѕЮ
­ЪЎЄРђЇРЎѓ№ИЈ	рѕ░рІЇ ріЦрІерѕ░рїѕрІ░
­ЪЎЄРђЇРЎѓ	рѕ░рІЇ ріЦрІерѕ░рїѕрІ░
­ЪЎЄ­ЪЈ╗РђЇРЎѓ№ИЈ	рѕ░рІЇ ріЦрІерѕ░рїѕрІ░рЇА рЅђрѕІрѕЇ рІерЅєрІ│ рЅђрѕѕрѕЮ
­ЪЎЄ­ЪЈ╗РђЇРЎѓ	рѕ░рІЇ ріЦрІерѕ░рїѕрІ░рЇА рЅђрѕІрѕЇ рІерЅєрІ│ рЅђрѕѕрѕЮ
­ЪЎЄ­ЪЈ╝РђЇРЎѓ№ИЈ	рѕ░рІЇ ріЦрІерѕ░рїѕрІ░рЇА рѕўрѕЃріерѕѕріЏ рЅђрѕІ рІФрѕѕ рІерЅєрІ│ рЅђрѕѕрѕЮ
­ЪЎЄ­ЪЈ╝РђЇРЎѓ	рѕ░рІЇ ріЦрІерѕ░рїѕрІ░рЇА рѕўрѕЃріерѕѕріЏ рЅђрѕІ рІФрѕѕ рІерЅєрІ│ рЅђрѕѕрѕЮ
­ЪЎЄ­ЪЈйРђЇРЎѓ№ИЈ	рѕ░рІЇ ріЦрІерѕ░рїѕрІ░рЇА рѕўрѕЃріерѕѕріЏ рІерЅєрІ│ рЅђрѕѕрѕЮ
­ЪЎЄ­ЪЈйРђЇРЎѓ	рѕ░рІЇ ріЦрІерѕ░рїѕрІ░рЇА рѕўрѕЃріерѕѕріЏ рІерЅєрІ│ рЅђрѕѕрѕЮ
­ЪЎЄ­ЪЈЙРђЇРЎѓ№ИЈ	рѕ░рІЇ ріЦрІерѕ░рїѕрІ░рЇА рѕўрѕЃріерѕѕріЏ рЅђрѕІ рІФрѕѕ рІерЅєрІ│ рЅђрѕѕрѕЮ
­ЪЎЄ­ЪЈЙРђЇРЎѓ	рѕ░рІЇ ріЦрІерѕ░рїѕрІ░рЇА рѕўрѕЃріерѕѕріЏ рЅђрѕІ рІФрѕѕ рІерЅєрІ│ рЅђрѕѕрѕЮ
­ЪЎЄ­ЪЈ┐РђЇРЎѓ№ИЈ	рѕ░рІЇ ріЦрІерѕ░рїѕрІ░рЇА рїЦрЅЂрѕГ рІерЅєрІ│ рЅђрѕѕрѕЮ
­ЪЎЄ­ЪЈ┐РђЇРЎѓ	рѕ░рІЇ ріЦрІерѕ░рїѕрІ░рЇА рїЦрЅЂрѕГ рІерЅєрІ│ рЅђрѕѕрѕЮ
­ЪЎЄРђЇРЎђ№ИЈ	рѕ┤рЅх рѕхрЅхрѕ░рїЇрІх
­ЪЎЄРђЇРЎђ	рѕ┤рЅх рѕхрЅхрѕ░рїЇрІх
­ЪЎЄ­ЪЈ╗РђЇРЎђ№ИЈ	рѕ┤рЅх ріЦрІерѕ░рїѕрІ░рЅйрЇА рЅђрѕІрѕЇ рІерЅєрІ│ рЅђрѕѕрѕЮ
­ЪЎЄ­ЪЈ╗РђЇРЎђ	рѕ┤рЅх ріЦрІерѕ░рїѕрІ░рЅйрЇА рЅђрѕІрѕЇ рІерЅєрІ│ рЅђрѕѕрѕЮ
­ЪЎЄ­ЪЈ╝РђЇРЎђ№ИЈ	рѕ┤рЅх ріЦрІерѕ░рїѕрІ░рЅйрЇА рѕўрѕЃріерѕѕріЏ рЅђрѕІ рІФрѕѕ рІерЅєрІ│ рЅђрѕѕрѕЮ
­ЪЎЄ­ЪЈ╝РђЇРЎђ	рѕ┤рЅх ріЦрІерѕ░рїѕрІ░рЅйрЇА рѕўрѕЃріерѕѕріЏ рЅђрѕІ рІФрѕѕ рІерЅєрІ│ рЅђрѕѕрѕЮ
­ЪЎЄ­ЪЈйРђЇРЎђ№ИЈ	рѕ┤рЅх ріЦрІерѕ░рїѕрІ░рЅйрЇА рѕўрѕЃріерѕѕріЏ рІерЅєрІ│ рЅђрѕѕрѕЮ
­ЪЎЄ­ЪЈйРђЇРЎђ	рѕ┤рЅх ріЦрІерѕ░рїѕрІ░рЅйрЇА рѕўрѕЃріерѕѕріЏ рІерЅєрІ│ рЅђрѕѕрѕЮ
­ЪЎЄ­ЪЈЙРђЇРЎђ№ИЈ	рѕ┤рЅх ріЦрІерѕ░рїѕрІ░рЅйрЇА рѕўрѕЃріерѕѕріЏ рЅђрѕІ рІФрѕѕ рІерЅєрІ│ рЅђрѕѕрѕЮ
­ЪЎЄ­ЪЈЙРђЇРЎђ	рѕ┤рЅх ріЦрІерѕ░рїѕрІ░рЅйрЇА рѕўрѕЃріерѕѕріЏ рЅђрѕІ рІФрѕѕ рІерЅєрІ│ рЅђрѕѕрѕЮ
­ЪЎЄ­ЪЈ┐РђЇРЎђ№ИЈ	рѕ┤рЅх ріЦрІерѕ░рїѕрІ░рЅй: рїЦрЅЂрѕГ рІерЅєрІ│ рЅђрѕѕрѕЮ
­ЪЎЄ­ЪЈ┐РђЇРЎђ	рѕ┤рЅх ріЦрІерѕ░рїѕрІ░рЅй: рїЦрЅЂрѕГ рІерЅєрІ│ рЅђрѕѕрѕЮ
­Ъцд	рЇірЅх рѕѕрЇірЅх рІерѕџрѕёрІх рѕ░рІЇ
­Ъцд­ЪЈ╗	рЇірЅх рЇЊрѕЇрѕџріЋрїЇ рѕ░рІЇрЇА рЅђрѕІрѕЇ рІерЅєрІ│ рЅђрѕѕрѕЮ
­Ъцд­ЪЈ╝	рѕ░рІЇ рЇірЅх рЇЊрѕЇрѕџріЋрїЇрЇА рѕўрѕЃріерѕѕріЏ рЅђрѕІ рІФрѕѕ рІерЅєрІ│ рЅђрѕѕрѕЮ
­Ъцд­ЪЈй	рЇірЅх рЇЊрѕЇрѕџріЋрїЇ рѕ░рІЇрЇА рѕўрѕЃріерѕѕріЏ рІерЅєрІ│ рЅђрѕѕрѕЮ
­Ъцд­ЪЈЙ	рЇірЅх рЇЊрѕЇрѕџріЋрїЇ рѕ░рІЇрЇА рѕўрѕЃріерѕѕріЏ рЅђрѕІ рІФрѕѕ рІерЅєрІ│ рЅђрѕѕрѕЮ
­Ъцд­ЪЈ┐	рЇірЅх рЇЊрѕЇрѕџріЋрїЇ рѕ░рІЇ: рїЦрЅЂрѕГ рІерЅєрІ│ рЅђрѕѕрѕЮ
­ЪцдРђЇРЎѓ№ИЈ	рѕ░рІЇ рЇірЅх рЇЊрѕЇрѕџріЋрїЇ
­ЪцдРђЇРЎѓ	рѕ░рІЇ рЇірЅх рЇЊрѕЇрѕџріЋрїЇ
­Ъцд­ЪЈ╗РђЇРЎѓ№ИЈ	man facepalming: рЅђрѕІрѕЇ рІерЅєрІ│ рЅђрѕѕрѕЮ
­Ъцд­ЪЈ╗РђЇРЎѓ	man facepalming: рЅђрѕІрѕЇ рІерЅєрІ│ рЅђрѕѕрѕЮ
­Ъцд­ЪЈ╝РђЇРЎѓ№ИЈ	man facepalming: рѕўрѕЃріерѕѕріЏ-рЅђрѕІрѕЇ рІерЅєрІ│ рЅђрѕѕрѕЮ
­Ъцд­ЪЈ╝РђЇРЎѓ	man facepalming: рѕўрѕЃріерѕѕріЏ-рЅђрѕІрѕЇ рІерЅєрІ│ рЅђрѕѕрѕЮ
­Ъцд­ЪЈйРђЇРЎѓ№ИЈ	man facepalming: рѕўрѕЃріерѕѕріЏ рІерЅєрІ│ рЅђрѕѕрѕЮ
­Ъцд­ЪЈйРђЇРЎѓ	man facepalming: рѕўрѕЃріерѕѕріЏ рІерЅєрІ│ рЅђрѕѕрѕЮ
­Ъцд­ЪЈЙРђЇРЎѓ№ИЈ	man facepalming: рѕўрѕЃріерѕѕріЏ-рїЦрЅЂрѕГ рІерЅєрІ│ рЅђрѕѕрѕЮ
­Ъцд­ЪЈЙРђЇРЎѓ	man facepalming: рѕўрѕЃріерѕѕріЏ-рїЦрЅЂрѕГ рІерЅєрІ│ рЅђрѕѕрѕЮ
­Ъцд­ЪЈ┐РђЇРЎѓ№ИЈ	рІѕріЋрІх рЇірЅх рЇЊрѕЇрѕџріЋрїЇ: рїЦрЅЂрѕГ рІерЅєрІ│ рЅђрѕѕрѕЮ
­Ъцд­ЪЈ┐РђЇРЎѓ	рІѕріЋрІх рЇірЅх рЇЊрѕЇрѕџріЋрїЇ: рїЦрЅЂрѕГ рІерЅєрІ│ рЅђрѕѕрѕЮ
­ЪцдРђЇРЎђ№ИЈ	рѕ┤рЅх рЇірЅх рЇЊрѕЇрѕЮ
­ЪцдРђЇРЎђ	рѕ┤рЅх рЇірЅх рЇЊрѕЇрѕЮ
­Ъцд­ЪЈ╗РђЇРЎђ№ИЈ	рІерЇірЅх рЇЊрѕЇрѕџріЋрїЇ рѕ┤рЅхрЇА рЅђрѕІрѕЇ рІерЅєрІ│ рЅђрѕѕрѕЮ
­Ъцд­ЪЈ╗РђЇРЎђ	рІерЇірЅх рЇЊрѕЇрѕџріЋрїЇ рѕ┤рЅхрЇА рЅђрѕІрѕЇ рІерЅєрІ│ рЅђрѕѕрѕЮ
­Ъцд­ЪЈ╝РђЇРЎђ№ИЈ	рІерЇірЅх рЇЊрѕЇрѕџріЋрїЇ рѕ┤рЅхрЇА рѕўрѕЃріерѕѕріЏ рЅђрѕІ рІФрѕѕ рІерЅєрІ│ рЅђрѕѕрѕЮ
­Ъцд­ЪЈ╝РђЇРЎђ	рІерЇірЅх рЇЊрѕЇрѕџріЋрїЇ рѕ┤рЅхрЇА рѕўрѕЃріерѕѕріЏ рЅђрѕІ рІФрѕѕ рІерЅєрІ│ рЅђрѕѕрѕЮ
­Ъцд­ЪЈйРђЇРЎђ№ИЈ	рѕ┤рЅх рЇірЅх рЇЊрѕЇрѕџріЋрїЇ: рѕўрѕЃріерѕѕріЏ рІерЅєрІ│ рЅђрѕѕрѕЮ
­Ъцд­ЪЈйРђЇРЎђ	рѕ┤рЅх рЇірЅх рЇЊрѕЇрѕџріЋрїЇ: рѕўрѕЃріерѕѕріЏ рІерЅєрІ│ рЅђрѕѕрѕЮ
­Ъцд­ЪЈЙРђЇРЎђ№ИЈ	рІерЇірЅх рѕўрІ│рЇЇ рѕ┤рЅхрЇА рѕўрѕЃріерѕѕріЏ рЅђрѕІ рІФрѕѕ рІерЅєрІ│ рЅђрѕѕрѕЮ
­Ъцд­ЪЈЙРђЇРЎђ	рІерЇірЅх рѕўрІ│рЇЇ рѕ┤рЅхрЇА рѕўрѕЃріерѕѕріЏ рЅђрѕІ рІФрѕѕ рІерЅєрІ│ рЅђрѕѕрѕЮ
­Ъцд­ЪЈ┐РђЇРЎђ№ИЈ	рѕ┤рЅх рЇірЅх рЇЊрѕЇрѕџріЋрїЇ: рїЦрЅЂрѕГ рІерЅєрІ│ рЅђрѕѕрѕЮ
­Ъцд­ЪЈ┐РђЇРЎђ	рѕ┤рЅх рЇірЅх рЇЊрѕЇрѕџріЋрїЇ: рїЦрЅЂрѕГ рІерЅєрІ│ рЅђрѕѕрѕЮ
­Ъци	рѕ░рІЇ ріЦрІеріљрЅђріљрЅђ
­Ъци­ЪЈ╗	рѕ░рІЇ ріЦрІерѕИрѕерѕИрѕерЇА рЅђрѕІрѕЇ рІерЅєрІ│ рЅђрѕѕрѕЮ
­Ъци­ЪЈ╝	рѕ░рІЇ ріЦрІФріЋрЅђрїарЅђрїАрЇА рѕўрѕЃріерѕѕріЏ рЅђрѕІ рІФрѕѕ рІерЅєрІ│ рЅђрѕѕрѕЮ
­Ъци­ЪЈй	рѕ░рІЇ ріЦрІерѕИрѕерѕИрѕерЇА рѕўрѕЃріерѕѕріЏ рІерЅєрІ│ рЅђрѕѕрѕЮ
­Ъци­ЪЈЙ	рѕ░рІЇ ріЦрІФріЋрЅђрїарЅђрїАрЇА рѕўрѕЃріерѕѕріЏ рЅђрѕІ рІФрѕѕ рІерЅєрІ│ рЅђрѕѕрѕЮ
­Ъци­ЪЈ┐	рѕ░рІЇ ріЦрІерЅ░ріЋрЅђрїарЅђрїАрЇА рїЦрЅЂрѕГ рІерЅєрІ│ рЅђрѕѕрѕЮ
­ЪциРђЇРЎѓ№ИЈ	рѕ░рІЇ ріЦрІеріљрЅђріљрЅђ
­ЪциРђЇРЎѓ	рѕ░рІЇ ріЦрІеріљрЅђріљрЅђ
­Ъци­ЪЈ╗РђЇРЎѓ№ИЈ	рѕ░рІЇ ріЦрІФрѕйріерѕеріерѕерЇА рЅђрѕІрѕЇ рІерЅєрІ│ рЅђрѕѕрѕЮ
­Ъци­ЪЈ╗РђЇРЎѓ	рѕ░рІЇ ріЦрІФрѕйріерѕеріерѕерЇА рЅђрѕІрѕЇ рІерЅєрІ│ рЅђрѕѕрѕЮ
­Ъци­ЪЈ╝РђЇРЎѓ№ИЈ	рѕ░рІЇ ріЦрІерїѕрЇІ: рѕўрѕЃріерѕѕріЏ рЅђрѕІ рІФрѕѕ рІерЅєрІ│ рЅђрѕѕрѕЮ
­Ъци­ЪЈ╝РђЇРЎѓ	рѕ░рІЇ ріЦрІерїѕрЇІ: рѕўрѕЃріерѕѕріЏ рЅђрѕІ рІФрѕѕ рІерЅєрІ│ рЅђрѕѕрѕЮ
­Ъци­ЪЈйРђЇРЎѓ№ИЈ	рѕ░рІЇ ріЦрІФрѕйрЅєрѕѕрЅєрѕѕ: рѕўрѕЃріерѕѕріЏ рІерЅєрІ│ рЅђрѕѕрѕЮ
­Ъци­ЪЈйРђЇРЎѓ	рѕ░рІЇ ріЦрІФрѕйрЅєрѕѕрЅєрѕѕ: рѕўрѕЃріерѕѕріЏ рІерЅєрІ│ рЅђрѕѕрѕЮ
­Ъци­ЪЈЙРђЇРЎѓ№ИЈ	рѕ░рІЇ ріЦрІФрѕйріерѕеріерѕерЇА рѕўрѕЃріерѕѕріЏ рЅђрѕІ рІФрѕѕ рІерЅєрІ│ рЅђрѕѕрѕЮ
­Ъци­ЪЈЙРђЇРЎѓ	рѕ░рІЇ ріЦрІФрѕйріерѕеріерѕерЇА рѕўрѕЃріерѕѕріЏ рЅђрѕІ рІФрѕѕ рІерЅєрІ│ рЅђрѕѕрѕЮ
­Ъци­ЪЈ┐РђЇРЎѓ№ИЈ	рѕ░рІЇ ріЦрІерїѕрЇІ: рїЦрЅЂрѕГ рІерЅєрІ│ рЅђрѕѕрѕЮ
­Ъци­ЪЈ┐РђЇРЎѓ	рѕ░рІЇ ріЦрІерїѕрЇІ: рїЦрЅЂрѕГ рІерЅєрІ│ рЅђрѕѕрѕЮ
­ЪциРђЇРЎђ№ИЈ	ріаріЋрІ▓рЅх рѕ┤рЅх рЅхріерѕ╗рІІріЋ ріЦрІеріљрЅђрѕѕрЅй
­ЪциРђЇРЎђ	ріаріЋрІ▓рЅх рѕ┤рЅх рЅхріерѕ╗рІІріЋ ріЦрІеріљрЅђрѕѕрЅй
­Ъци­ЪЈ╗РђЇРЎђ№ИЈ	рѕ┤рЅх рЅхріерѕ╗рІІріЋ: рЅђрѕІрѕЇ рІерЅєрІ│ рЅђрѕѕрѕЮ
­Ъци­ЪЈ╗РђЇРЎђ	рѕ┤рЅх рЅхріерѕ╗рІІріЋ: рЅђрѕІрѕЇ рІерЅєрІ│ рЅђрѕѕрѕЮ
­Ъци­ЪЈ╝РђЇРЎђ№ИЈ	рѕ┤рЅх рЅхріерѕ╗: рѕўрѕЃріерѕѕріЏ рЅђрѕІ рІФрѕѕ рІерЅєрІ│ рЅђрѕѕрѕЮ
­Ъци­ЪЈ╝РђЇРЎђ	рѕ┤рЅх рЅхріерѕ╗: рѕўрѕЃріерѕѕріЏ рЅђрѕІ рІФрѕѕ рІерЅєрІ│ рЅђрѕѕрѕЮ
­Ъци­ЪЈйРђЇРЎђ№ИЈ	рѕ┤рЅх рЅхріерѕ╗: рѕўрѕЃріерѕѕріЏ рІерЅєрІ│ рЅђрѕѕрѕЮ
­Ъци­ЪЈйРђЇРЎђ	рѕ┤рЅх рЅхріерѕ╗: рѕўрѕЃріерѕѕріЏ рІерЅєрІ│ рЅђрѕѕрѕЮ
­Ъци­ЪЈЙРђЇРЎђ№ИЈ	рѕ┤рЅх рЅхріерѕ╗рІІріЋ ріЦрІерїерѕерѕ░рЅйрЇА рѕўрѕЃріерѕѕріЏ рЅђрѕІ рІФрѕѕ рІерЅєрІ│ рЅђрѕѕрѕЮ
­Ъци­ЪЈЙРђЇРЎђ	рѕ┤рЅх рЅхріерѕ╗рІІріЋ ріЦрІерїерѕерѕ░рЅйрЇА рѕўрѕЃріерѕѕріЏ рЅђрѕІ рІФрѕѕ рІерЅєрІ│ рЅђрѕѕрѕЮ
­Ъци­ЪЈ┐РђЇРЎђ№ИЈ	рѕ┤рЅх рЅхріерѕ╗рІІріЋ: рїЦрЅЂрѕГ рІерЅєрІ│ рЅђрѕѕрѕЮ
­Ъци­ЪЈ┐РђЇРЎђ	рѕ┤рЅх рЅхріерѕ╗рІІріЋ: рїЦрЅЂрѕГ рІерЅєрІ│ рЅђрѕѕрѕЮ
­Ъњє	рѕ░рІЇ рѕЏрѕИрЅх
­Ъњє­ЪЈ╗	рѕўрЅ│рѕИрЅх рІерѕџрІѕрѕхрІх рѕ░рІЇрЇА рЅђрѕІрѕЇ рІерЅєрІ│ рЅђрѕѕрѕЮ
­Ъњє­ЪЈ╝	рѕўрЅ│рѕИрЅх рІерѕџрІѕрѕхрІх рѕ░рІЇрЇА рѕўрѕЃріерѕѕріЏ рЅђрѕІ рІФрѕѕ рІерЅєрІ│ рЅђрѕѕрѕЮ
­Ъњє­ЪЈй	рѕўрЅ│рѕИрЅх рІерѕџрІѕрѕхрІх рѕ░рІЇрЇА рѕўрѕЃріерѕѕріЏ рІерЅєрІ│ рЅђрѕѕрѕЮ
­Ъњє­ЪЈЙ	рѕўрЅ│рѕИрЅх рІерѕџрІѕрѕхрІх рѕ░рІЇрЇА рѕўрѕЃріерѕѕріЏ рЅђрѕІ рІФрѕѕ рІерЅєрІ│ рЅђрѕѕрѕЮ
­Ъњє­ЪЈ┐	рѕўрЅ│рѕИрЅх рІерѕџрІѕрѕхрІх рѕ░рІЇрЇА рїЦрЅЂрѕГ рІерЅєрІ│ рЅђрѕѕрѕЮ
­ЪњєРђЇРЎѓ№ИЈ	рѕ░рІЇрІерІЇ рѕўрЅ│рѕИрЅх ріЦрІФрїѕріў ріљрІЇрЇб
­ЪњєРђЇРЎѓ	рѕ░рІЇрІерІЇ рѕўрЅ│рѕИрЅх ріЦрІФрїѕріў ріљрІЇрЇб
­Ъњє­ЪЈ╗РђЇРЎѓ№ИЈ	рѕ░рІЇ рѕЏрѕИрЅх: рЅђрѕІрѕЇ рІерЅєрІ│ рЅђрѕѕрѕЮ
­Ъњє­ЪЈ╗РђЇРЎѓ	рѕ░рІЇ рѕЏрѕИрЅх: рЅђрѕІрѕЇ рІерЅєрІ│ рЅђрѕѕрѕЮ
­Ъњє­ЪЈ╝РђЇРЎѓ№ИЈ	рѕ░рІЇ рѕЏрѕИрЅх: рѕўрѕЃріерѕѕріЏ рЅђрѕІ рІФрѕѕ рІерЅєрІ│ рЅђрѕѕрѕЮ
­Ъњє­ЪЈ╝РђЇРЎѓ	рѕ░рІЇ рѕЏрѕИрЅх: рѕўрѕЃріерѕѕріЏ рЅђрѕІ рІФрѕѕ рІерЅєрІ│ рЅђрѕѕрѕЮ
­Ъњє­ЪЈйРђЇРЎѓ№ИЈ	рѕ░рІЇ рѕЏрѕИрЅх ріЦрІерІѕрѕ░рІ░: рѕўрѕЃріерѕѕріЏ рІерЅєрІ│ рЅђрѕѕрѕЮ
­Ъњє­ЪЈйРђЇРЎѓ	рѕ░рІЇ рѕЏрѕИрЅх ріЦрІерІѕрѕ░рІ░: рѕўрѕЃріерѕѕріЏ рІерЅєрІ│ рЅђрѕѕрѕЮ
­Ъњє­ЪЈЙРђЇРЎѓ№ИЈ	рѕ░рІЇ рѕЏрѕИрЅх ріЦрІерІѕрѕ░рІ░: рѕўрѕЃріерѕѕріЏ рЅђрѕІ рІФрѕѕ рІерЅєрІ│ рЅђрѕѕрѕЮ
­Ъњє­ЪЈЙРђЇРЎѓ	рѕ░рІЇ рѕЏрѕИрЅх ріЦрІерІѕрѕ░рІ░: рѕўрѕЃріерѕѕріЏ рЅђрѕІ рІФрѕѕ рІерЅєрІ│ рЅђрѕѕрѕЮ
­Ъњє­ЪЈ┐РђЇРЎѓ№ИЈ	рѕ░рІЇ рѕЏрѕИрЅх: рїЦрЅЂрѕГ рІерЅєрІ│ рЅђрѕѕрѕЮ
­Ъњє­ЪЈ┐РђЇРЎѓ	рѕ░рІЇ рѕЏрѕИрЅх: рїЦрЅЂрѕГ рІерЅєрІ│ рЅђрѕѕрѕЮ
­ЪњєРђЇРЎђ№ИЈ	рѕ┤рЅх рѕўрЅ│рѕИрЅх ріЦрІФрїѕріўрЅй ріљрІЇрЇб
­ЪњєРђЇРЎђ	рѕ┤рЅх рѕўрЅ│рѕИрЅх ріЦрІФрїѕріўрЅй ріљрІЇрЇб
­Ъњє­ЪЈ╗РђЇРЎђ№ИЈ	рѕ┤рЅх рѕўрЅ│рѕИрЅх рЅ│рїѕріЏрѕѕрЅйрЇА рЅђрѕІрѕЇ рІерЅєрІ│ рЅђрѕѕрѕЮ
­Ъњє­ЪЈ╗РђЇРЎђ	рѕ┤рЅх рѕўрЅ│рѕИрЅх рЅ│рїѕріЏрѕѕрЅйрЇА рЅђрѕІрѕЇ рІерЅєрІ│ рЅђрѕѕрѕЮ
­Ъњє­ЪЈ╝РђЇРЎђ№ИЈ	рѕ┤рЅх рѕўрЅ│рѕИрЅх рЅ│рїѕріЏрѕѕрЅйрЇА рѕўрѕЃріерѕѕріЏ рЅђрѕІ рІФрѕѕ рІерЅєрІ│ рЅђрѕѕрѕЮ
­Ъњє­ЪЈ╝РђЇРЎђ	рѕ┤рЅх рѕўрЅ│рѕИрЅх рЅ│рїѕріЏрѕѕрЅйрЇА рѕўрѕЃріерѕѕріЏ рЅђрѕІ рІФрѕѕ рІерЅєрІ│ рЅђрѕѕрѕЮ
­Ъњє­ЪЈйРђЇРЎђ№ИЈ	рѕ┤рЅх рѕўрЅ│рѕИрЅх рЅ│рїѕріЏрѕѕрЅйрЇА рѕўрѕЃріерѕѕріЏ рІерЅєрІ│ рЅђрѕѕрѕЮ
­Ъњє­ЪЈйРђЇРЎђ	рѕ┤рЅх рѕўрЅ│рѕИрЅх рЅ│рїѕріЏрѕѕрЅйрЇА рѕўрѕЃріерѕѕріЏ рІерЅєрІ│ рЅђрѕѕрѕЮ
­Ъњє­ЪЈЙРђЇРЎђ№ИЈ	рѕ┤рЅх рѕўрЅ│рѕИрЅх рЅ│рїѕріЏрѕѕрЅйрЇА рѕўрѕЃріерѕѕріЏ рЅђрѕІ рІФрѕѕ рІерЅєрІ│ рЅђрѕѕрѕЮ
­Ъњє­ЪЈЙРђЇРЎђ	рѕ┤рЅх рѕўрЅ│рѕИрЅх рЅ│рїѕріЏрѕѕрЅйрЇА рѕўрѕЃріерѕѕріЏ рЅђрѕІ рІФрѕѕ рІерЅєрІ│ рЅђрѕѕрѕЮ
­Ъњє­ЪЈ┐РђЇРЎђ№ИЈ	рѕ┤рЅх рѕўрЅ│рѕИрЅх рЅ│рїѕріЏрѕѕрЅйрЇА рІерЅєрІ│ рЅђрѕѕрѕЮ
­Ъњє­ЪЈ┐РђЇРЎђ	рѕ┤рЅх рѕўрЅ│рѕИрЅх рЅ│рїѕріЏрѕѕрЅй: рїЦрЅЂрѕГ рІерЅєрІ│ рЅђрѕѕрѕЮ
­ЪњЄ	рЇђрїЅрѕГ рІерѕџрІФрѕхрЅ░ріФріГрѕЇ рѕ░рІЇ
­ЪњЄ­ЪЈ╗	рЇђрїЅрѕГ рІерѕџрІФрѕхрЅ░ріФріГрѕЇ рѕ░рІЇрЇА рЅђрѕІрѕЇ рІерЅєрІ│ рЅђрѕѕрѕЮ
­ЪњЄ­ЪЈ╝	рЇђрїЅрѕГ рІерѕџрІФрѕхрЅ░ріФріГрѕЇ рѕ░рІЇрЇА рѕўрѕЃріерѕѕріЏ рЅђрѕІ рІФрѕѕ рІерЅєрІ│ рЅђрѕѕрѕЮ
­ЪњЄ­ЪЈй	рЇђрїЅрѕГ рІерѕџрІФрѕхрЅ░ріФріГрѕЇ рѕ░рІЇ: рѕўрѕЃріерѕѕріЏ рІерЅєрІ│ рЅђрѕѕрѕЮ
­ЪњЄ­ЪЈЙ	рЇђрїЅрѕГ рІерѕџрІФрѕхрЅ░ріФріГрѕЇ рѕ░рІЇрЇА рѕўрѕЃріерѕѕріЏ рЅђрѕІ рІФрѕѕ рІерЅєрІ│ рЅђрѕѕрѕЮ
­ЪњЄ­ЪЈ┐	рЇђрїЅрѕГ рІерѕџрІФрѕхрЅ░ріФріГрѕЇ рѕ░рІЇ: рїЦрЅЂрѕГ рІерЅєрІ│ рЅђрѕѕрѕЮ
­ЪњЄРђЇРЎѓ№ИЈ	рЇђрїЅрѕГ ріЦрІерЅєрѕерїа рІФрѕѕрІЇ рѕ░рІЇ
­ЪњЄРђЇРЎѓ	рЇђрїЅрѕГ ріЦрІерЅєрѕерїа рІФрѕѕрІЇ рѕ░рІЇ
­ЪњЄ­ЪЈ╗РђЇРЎѓ№ИЈ	рЇђрїЅрѕГ ріЦрІерЅєрѕерїа рІФрѕѕрІЇ рѕ░рІЇ: рЅђрѕІрѕЇ рІерЅєрІ│ рЅђрѕѕрѕЮ
­ЪњЄ­ЪЈ╗РђЇРЎѓ	рЇђрїЅрѕГ ріЦрІерЅєрѕерїа рІФрѕѕрІЇ рѕ░рІЇ: рЅђрѕІрѕЇ рІерЅєрІ│ рЅђрѕѕрѕЮ
­ЪњЄ­ЪЈ╝РђЇРЎѓ№ИЈ	рЇђрїЅрѕГ ріЦрІерЅєрѕерїа рІФрѕѕрІЇ рѕ░рІЇрЇА рѕўрѕЃріерѕѕріЏ рЅђрѕІ рІФрѕѕ рІерЅєрІ│ рЅђрѕѕрѕЮ
­ЪњЄ­ЪЈ╝РђЇРЎѓ	рЇђрїЅрѕГ ріЦрІерЅєрѕерїа рІФрѕѕрІЇ рѕ░рІЇрЇА рѕўрѕЃріерѕѕріЏ рЅђрѕІ рІФрѕѕ рІерЅєрІ│ рЅђрѕѕрѕЮ
­ЪњЄ­ЪЈйРђЇРЎѓ№ИЈ	рЇђрїЅрѕГ ріЦрІерЅєрѕерїа рІФрѕѕрІЇ рѕ░рІЇ: рѕўрѕЃріерѕѕріЏ рІерЅєрІ│ рЅђрѕѕрѕЮ
­ЪњЄ­ЪЈйРђЇРЎѓ	рЇђрїЅрѕГ ріЦрІерЅєрѕерїа рІФрѕѕрІЇ рѕ░рІЇ: рѕўрѕЃріерѕѕріЏ рІерЅєрІ│ рЅђрѕѕрѕЮ
­ЪњЄ­ЪЈЙРђЇРЎѓ№ИЈ	рЇђрїЅрѕГ ріЦрІерЅєрѕерїа рІФрѕѕрІЇ рѕ░рІЇрЇА рѕўрѕЃріерѕѕріЏ рЅђрѕІ рІФрѕѕ рІерЅєрІ│ рЅђрѕѕрѕЮ
­ЪњЄ­ЪЈЙРђЇРЎѓ	рЇђрїЅрѕГ ріЦрІерЅєрѕерїа рІФрѕѕрІЇ рѕ░рІЇрЇА рѕўрѕЃріерѕѕріЏ рЅђрѕІ рІФрѕѕ рІерЅєрІ│ рЅђрѕѕрѕЮ
­ЪњЄ­ЪЈ┐РђЇРЎѓ№ИЈ	рЇђрїЅрѕГ ріЦрІерЅєрѕерїа рІФрѕѕрІЇ рѕ░рІЇ: рїЦрЅЂрѕГ рІерЅєрІ│ рЅђрѕѕрѕЮ
­ЪњЄ­ЪЈ┐РђЇРЎѓ	рЇђрїЅрѕГ ріЦрІерЅєрѕерїа рІФрѕѕрІЇ рѕ░рІЇ: рїЦрЅЂрѕГ рІерЅєрІ│ рЅђрѕѕрѕЮ
­ЪњЄРђЇРЎђ№ИЈ	рѕ┤рЅх рЇђрїЅрѕГ рѕхрЅхрЅєрѕГрїЦ
­ЪњЄРђЇРЎђ	рѕ┤рЅх рЇђрїЅрѕГ рѕхрЅхрЅєрѕГрїЦ
­ЪњЄ­ЪЈ╗РђЇРЎђ№ИЈ	рѕ┤рЅх рЇђрїЅрѕГ рѕхрЅхрЅєрѕГрїЦ: рЅђрѕІрѕЇ рІерЅєрІ│ рЅђрѕѕрѕЮ
­ЪњЄ­ЪЈ╗РђЇРЎђ	рѕ┤рЅх рЇђрїЅрѕГ рѕхрЅхрЅєрѕГрїЦ: рЅђрѕІрѕЇ рІерЅєрІ│ рЅђрѕѕрѕЮ
­ЪњЄ­ЪЈ╝РђЇРЎђ№ИЈ	рЇђрїЅрѕГ рІерѕЮрЅ│рѕхрЅ░ріФріГрѕЇ рѕ┤рЅхрЇА рѕўрѕЃріерѕѕріЏ рЅђрѕІ рІФрѕѕ рІерЅєрІ│ рЅђрѕѕрѕЮ
­ЪњЄ­ЪЈ╝РђЇРЎђ	рЇђрїЅрѕГ рІерѕЮрЅ│рѕхрЅ░ріФріГрѕЇ рѕ┤рЅхрЇА рѕўрѕЃріерѕѕріЏ рЅђрѕІ рІФрѕѕ рІерЅєрІ│ рЅђрѕѕрѕЮ
­ЪњЄ­ЪЈйРђЇРЎђ№ИЈ	рѕ┤рЅх рЇђрїЅрѕГ рѕхрЅхрЅєрѕГрїЦ: рѕўрѕЃріерѕѕріЏ рІерЅєрІ│ рЅђрѕѕрѕЮ
­ЪњЄ­ЪЈйРђЇРЎђ	рѕ┤рЅх рЇђрїЅрѕГ рѕхрЅхрЅєрѕГрїЦ: рѕўрѕЃріерѕѕріЏ рІерЅєрІ│ рЅђрѕѕрѕЮ
­ЪњЄ­ЪЈЙРђЇРЎђ№ИЈ	рѕ┤рЅх рЇђрїЅрѕГ рѕхрЅхрЅєрѕерїЦрЇА рѕўрѕЃріерѕѕріЏ рЅђрѕІ рІФрѕѕ рІерЅєрІ│ рЅђрѕѕрѕЮ
­ЪњЄ­ЪЈЙРђЇРЎђ	рѕ┤рЅх рЇђрїЅрѕГ рѕхрЅхрЅєрѕерїЦрЇА рѕўрѕЃріерѕѕріЏ рЅђрѕІ рІФрѕѕ рІерЅєрІ│ рЅђрѕѕрѕЮ
­ЪњЄ­ЪЈ┐РђЇРЎђ№ИЈ	рЇђрїЅрѕГ рІерѕЮрЅ│рѕхрЅ░ріФріГрѕЇ рѕ┤рЅх: рїЦрЅЂрѕГ рІерЅєрІ│ рЅђрѕѕрѕЮ
­ЪњЄ­ЪЈ┐РђЇРЎђ	рЇђрїЅрѕГ рІерѕЮрЅ│рѕхрЅ░ріФріГрѕЇ рѕ┤рЅх: рїЦрЅЂрѕГ рІерЅєрІ│ рЅђрѕѕрѕЮ
­ЪџХ	рІерѕџрѕФрѕўрІх рѕ░рІЇ
­ЪџХ­ЪЈ╗	рІерѕџрѕФрѕўрІх рѕ░рІЇ: рЅђрѕІрѕЇ рІерЅєрІ│ рЅђрѕѕрѕЮ
­ЪџХ­ЪЈ╝	рІерѕџрѕФрѕўрІх рѕ░рІЇрЇА рѕўрѕЃріерѕѕріЏ рЅђрѕІ рІФрѕѕ рІерЅєрІ│ рЅђрѕѕрѕЮ
­ЪџХ­ЪЈй	рІерѕџрѕФрѕўрІх рѕ░рІЇ: рѕўрѕЃріерѕѕріЏ рІерЅєрІ│ рЅђрѕѕрѕЮ
­ЪџХ­ЪЈЙ	рІерѕџрѕФрѕўрІх рѕ░рІЇрЇА рѕўрѕЃріерѕѕріЏ рЅђрѕІ рІФрѕѕ рІерЅєрІ│ рЅђрѕѕрѕЮ
­ЪџХ­ЪЈ┐	рІерѕџрѕФрѕўрІх рѕ░рІЇ: рїЦрЅЂрѕГ рІерЅєрІ│ рЅђрѕѕрѕЮ
­ЪџХРђЇРЎѓ№ИЈ	рѕ░рІЇ рІерѕџрѕФрѕўрІх
­ЪџХРђЇРЎѓ	рѕ░рІЇ рІерѕџрѕФрѕўрІх
­ЪџХ­ЪЈ╗РђЇРЎѓ№ИЈ	рѕ░рІЇ рІерѕџрѕФрѕўрІх: рЅђрѕІрѕЇ рІерЅєрІ│ рЅђрѕѕрѕЮ
­ЪџХ­ЪЈ╗РђЇРЎѓ	рѕ░рІЇ рІерѕџрѕФрѕўрІх: рЅђрѕІрѕЇ рІерЅєрІ│ рЅђрѕѕрѕЮ
­ЪџХ­ЪЈ╝РђЇРЎѓ№ИЈ	рѕ░рІЇ рІерѕџрѕФрѕўрІх: рѕўрѕЃріерѕѕріЏ рЅђрѕІ рІФрѕѕ рІерЅєрІ│ рЅђрѕѕрѕЮ
­ЪџХ­ЪЈ╝РђЇРЎѓ	рѕ░рІЇ рІерѕџрѕФрѕўрІх: рѕўрѕЃріерѕѕріЏ рЅђрѕІ рІФрѕѕ рІерЅєрІ│ рЅђрѕѕрѕЮ
­ЪџХ­ЪЈйРђЇРЎѓ№ИЈ	рѕ░рІЇ рІерѕџрѕФрѕўрІх: рѕўрѕЃріерѕѕріЏ рІерЅєрІ│ рЅђрѕѕрѕЮ
­ЪџХ­ЪЈйРђЇРЎѓ	рѕ░рІЇ рІерѕџрѕФрѕўрІх: рѕўрѕЃріерѕѕріЏ рІерЅєрІ│ рЅђрѕѕрѕЮ
­ЪџХ­ЪЈЙРђЇРЎѓ№ИЈ	рІерѕџрѕФрѕўрІх рѕ░рІЇ: рѕўрѕЃріерѕѕріЏ-рїЦрЅЂрѕГ рІерЅєрІ│ рЅђрѕѕрѕЮ
­ЪџХ­ЪЈЙРђЇРЎѓ	рІерѕџрѕФрѕўрІх рѕ░рІЇ: рѕўрѕЃріерѕѕріЏ-рїЦрЅЂрѕГ рІерЅєрІ│ рЅђрѕѕрѕЮ
­ЪџХ­ЪЈ┐РђЇРЎѓ№ИЈ	рѕ░рІЇ рІерѕџрѕФрѕўрІх: рїЦрЅЂрѕГ рІерЅєрІ│ рЅђрѕѕрѕЮ
­ЪџХ­ЪЈ┐РђЇРЎѓ	рѕ░рІЇ рІерѕџрѕФрѕўрІх: рїЦрЅЂрѕГ рІерЅєрІ│ рЅђрѕѕрѕЮ
­ЪџХРђЇРЎђ№ИЈ	рѕ┤рЅх ріЦрІерЅ░рѕФрѕўрІ░рЅй
­ЪџХРђЇРЎђ	рѕ┤рЅх ріЦрІерЅ░рѕФрѕўрІ░рЅй
­ЪџХ­ЪЈ╗РђЇРЎђ№ИЈ	рѕ┤рЅх рѕўрѕФрѕўрІх: рЅђрѕІрѕЇ рІерЅєрІ│ рЅђрѕѕрѕЮ
­ЪџХ­ЪЈ╗РђЇРЎђ	рѕ┤рЅх рѕўрѕФрѕўрІх: рЅђрѕІрѕЇ рІерЅєрІ│ рЅђрѕѕрѕЮ
­ЪџХ­ЪЈ╝РђЇРЎђ№ИЈ	рѕ┤рЅх рѕўрѕФрѕўрІх: рѕўрѕЃріерѕѕріЏ рЅђрѕІ рІФрѕѕ рІерЅєрІ│ рЅђрѕѕрѕЮ
­ЪџХ­ЪЈ╝РђЇРЎђ	рѕ┤рЅх рѕўрѕФрѕўрІх: рѕўрѕЃріерѕѕріЏ рЅђрѕІ рІФрѕѕ рІерЅєрІ│ рЅђрѕѕрѕЮ
­ЪџХ­ЪЈйРђЇРЎђ№ИЈ	рѕ┤рЅх рѕўрѕФрѕўрІх: рѕўрѕЃріерѕѕріЏ рІерЅєрІ│ рЅђрѕѕрѕЮ
­ЪџХ­ЪЈйРђЇРЎђ	рѕ┤рЅх рѕўрѕФрѕўрІх: рѕўрѕЃріерѕѕріЏ рІерЅєрІ│ рЅђрѕѕрѕЮ
­ЪџХ­ЪЈЙРђЇРЎђ№ИЈ	рѕ┤рЅх рѕўрѕФрѕўрІх: рѕўрѕЃріерѕѕріЏ-рїЦрЅЂрѕГ рІерЅєрІ│ рЅђрѕѕрѕЮ
­ЪџХ­ЪЈЙРђЇРЎђ	рѕ┤рЅх рѕўрѕФрѕўрІх: рѕўрѕЃріерѕѕріЏ-рїЦрЅЂрѕГ рІерЅєрІ│ рЅђрѕѕрѕЮ
­ЪџХ­ЪЈ┐РђЇРЎђ№ИЈ	рІерѕЮрЅхрѕёрІх рѕ┤рЅх: рїЦрЅЂрѕГ рІерЅєрІ│ рЅђрѕѕрѕЮ
­ЪџХ­ЪЈ┐РђЇРЎђ	рІерѕЮрЅхрѕёрІх рѕ┤рЅх: рїЦрЅЂрѕГ рІерЅєрІ│ рЅђрѕѕрѕЮ
­ЪЈЃ	рѕ░рІЇ ріЦрІерѕ«рїа ріљрІЇрЇб
­ЪЈЃ­ЪЈ╗	рІерѕџрѕ«рїЦ рѕ░рІЇрЇА рЅђрѕІрѕЇ рІерЅєрІ│ рЅђрѕѕрѕЮ
­ЪЈЃ­ЪЈ╝	рІерѕџрѕ«рїЦ рѕ░рІЇрЇА рѕўрѕЃріерѕѕріЏ рЅђрѕІ рІФрѕѕ рІерЅєрІ│ рЅђрѕѕрѕЮ
­ЪЈЃ­ЪЈй	рІерѕџрѕ«рїЦ рѕ░рІЇрЇА рѕўрѕЃріерѕѕріЏ рІерЅєрІ│ рЅђрѕѕрѕЮ
­ЪЈЃ­ЪЈЙ	рІерѕџрѕ«рїЦ рѕ░рІЇрЇА рѕўрѕЃріерѕѕріЏ рЅђрѕІ рІФрѕѕ рІерЅєрІ│ рЅђрѕѕрѕЮ
­ЪЈЃ­ЪЈ┐	рІерѕџрѕ«рїЦ рѕ░рІЇ: рїЦрЅЂрѕГ рІерЅєрІ│ рЅђрѕѕрѕЮ
­ЪЈЃРђЇРЎѓ№ИЈ	рѕ░рІЇ ріЦрІерѕ«рїа
­ЪЈЃРђЇРЎѓ	рѕ░рІЇ ріЦрІерѕ«рїа
­ЪЈЃ­ЪЈ╗РђЇРЎѓ№ИЈ	рѕ░рІЇ ріЦрІерѕ«рїа: рЅђрѕІрѕЇ рІерЅєрІ│ рЅђрѕѕрѕЮ
­ЪЈЃ­ЪЈ╗РђЇРЎѓ	рѕ░рІЇ ріЦрІерѕ«рїа: рЅђрѕІрѕЇ рІерЅєрІ│ рЅђрѕѕрѕЮ
­ЪЈЃ­ЪЈ╝РђЇРЎѓ№ИЈ	рѕ░рІЇ ріЦрІерѕ«рїа: рѕўрѕЃріерѕѕріЏ рЅђрѕІ рІФрѕѕ рІерЅєрІ│ рЅђрѕѕрѕЮ
­ЪЈЃ­ЪЈ╝РђЇРЎѓ	рѕ░рІЇ ріЦрІерѕ«рїа: рѕўрѕЃріерѕѕріЏ рЅђрѕІ рІФрѕѕ рІерЅєрІ│ рЅђрѕѕрѕЮ
­ЪЈЃ­ЪЈйРђЇРЎѓ№ИЈ	рѕ░рІЇ ріЦрІерѕ«рїа: рѕўрѕЃріерѕѕріЏ рІерЅєрІ│ рЅђрѕѕрѕЮ
­ЪЈЃ­ЪЈйРђЇРЎѓ	рѕ░рІЇ ріЦрІерѕ«рїа: рѕўрѕЃріерѕѕріЏ рІерЅєрІ│ рЅђрѕѕрѕЮ
­ЪЈЃ­ЪЈЙРђЇРЎѓ№ИЈ	рѕ░рІЇ ріЦрІерѕ«рїа: рѕўрѕЃріерѕѕріЏ-рїЦрЅЂрѕГ рІерЅєрІ│ рЅђрѕѕрѕЮ
­ЪЈЃ­ЪЈЙРђЇРЎѓ	рѕ░рІЇ ріЦрІерѕ«рїа: рѕўрѕЃріерѕѕріЏ-рїЦрЅЂрѕГ рІерЅєрІ│ рЅђрѕѕрѕЮ
­ЪЈЃ­ЪЈ┐РђЇРЎѓ№ИЈ	рѕ░рІЇ ріЦрІерѕ«рїа: рїЦрЅЂрѕГ рІерЅєрІ│ рЅђрѕѕрѕЮ
­ЪЈЃ­ЪЈ┐РђЇРЎѓ	рѕ░рІЇ ріЦрІерѕ«рїа: рїЦрЅЂрѕГ рІерЅєрІ│ рЅђрѕѕрѕЮ
­ЪЈЃРђЇРЎђ№ИЈ	рѕ┤рЅх ріЦрІерѕ«рїарЅй
­ЪЈЃРђЇРЎђ	рѕ┤рЅх ріЦрІерѕ«рїарЅй
­ЪЈЃ­ЪЈ╗РђЇРЎђ№ИЈ	рѕ┤рЅх ріЦрІерѕ«рїа: рЅђрѕІрѕЇ рІерЅєрІ│ рЅђрѕѕрѕЮ
­ЪЈЃ­ЪЈ╗РђЇРЎђ	рѕ┤рЅх ріЦрІерѕ«рїа: рЅђрѕІрѕЇ рІерЅєрІ│ рЅђрѕѕрѕЮ
­ЪЈЃ­ЪЈ╝РђЇРЎђ№ИЈ	рѕ┤рЅх ріЦрІерѕ«рїа: рѕўрѕЃріерѕѕріЏ рЅђрѕІ рІФрѕѕ рІерЅєрІ│ рЅђрѕѕрѕЮ
­ЪЈЃ­ЪЈ╝РђЇРЎђ	рѕ┤рЅх ріЦрІерѕ«рїа: рѕўрѕЃріерѕѕріЏ рЅђрѕІ рІФрѕѕ рІерЅєрІ│ рЅђрѕѕрѕЮ
­ЪЈЃ­ЪЈйРђЇРЎђ№ИЈ	рѕ┤рЅх ріЦрІерѕ«рїа: рѕўрѕЃріерѕѕріЏ рІерЅєрІ│ рЅђрѕѕрѕЮ
­ЪЈЃ­ЪЈйРђЇРЎђ	рѕ┤рЅх ріЦрІерѕ«рїа: рѕўрѕЃріерѕѕріЏ рІерЅєрІ│ рЅђрѕѕрѕЮ
­ЪЈЃ­ЪЈЙРђЇРЎђ№ИЈ	рѕ┤рЅх ріЦрІерѕ«рїа: рѕўрѕЃріерѕѕріЏ-рїЦрЅЂрѕГ рІерЅєрІ│ рЅђрѕѕрѕЮ
­ЪЈЃ­ЪЈЙРђЇРЎђ	рѕ┤рЅх ріЦрІерѕ«рїа: рѕўрѕЃріерѕѕріЏ-рїЦрЅЂрѕГ рІерЅєрІ│ рЅђрѕѕрѕЮ
­ЪЈЃ­ЪЈ┐РђЇРЎђ№ИЈ	рѕ┤рЅх ріЦрІерѕ«рїа: рїЦрЅЂрѕГ рІерЅєрІ│ рЅђрѕѕрѕЮ
­ЪЈЃ­ЪЈ┐РђЇРЎђ	рѕ┤рЅх ріЦрІерѕ«рїа: рїЦрЅЂрѕГ рІерЅєрІ│ рЅђрѕѕрѕЮ
­ЪњЃ	рѕ┤рЅх рІ│ріЋрѕх
­ЪњЃ­ЪЈ╗	рѕ┤рЅх рІ│ріЋрѕх: рЅђрѕІрѕЇ рІерЅєрІ│ рЅђрѕѕрѕЮ
­ЪњЃ­ЪЈ╝	рѕ┤рЅх рІ│ріЋрѕх: рѕўрѕЃріерѕѕріЏ рЅђрѕІ рІФрѕѕ рІерЅєрІ│ рЅђрѕѕрѕЮ
­ЪњЃ­ЪЈй	рѕ┤рЅх рІ│ріЋрѕх: рѕўрѕЃріерѕѕріЏ рІерЅєрІ│ рЅђрѕѕрѕЮ
­ЪњЃ­ЪЈЙ	рѕ┤рЅх рІ│ріЋрѕх: рѕўрѕЃріерѕѕріЏ-рїЦрЅЂрѕГ рІерЅєрІ│ рЅђрѕѕрѕЮ
­ЪњЃ­ЪЈ┐	рѕ┤рЅх рІ│ріЋрѕх: рїЦрЅЂрѕГ рІерЅєрІ│ рЅђрѕѕрѕЮ
­ЪЋ║	рѕ░рІЇ рѕўрІ░ріљрѕх
­ЪЋ║­ЪЈ╗	рѕ░рІЇ рІ│ріЋрѕх: рЅђрѕІрѕЇ рІерЅєрІ│ рЅђрѕѕрѕЮ
­ЪЋ║­ЪЈ╝	рѕ░рІЇ рІ│ріЋрѕх: рѕўрѕЃріерѕѕріЏ рЅђрѕІ рІФрѕѕ рІерЅєрІ│ рЅђрѕѕрѕЮ
­ЪЋ║­ЪЈй	рѕ░рІЇ рІ│ріЋрѕх: рѕўрѕЃріерѕѕріЏ рІерЅєрІ│ рЅђрѕѕрѕЮ
­ЪЋ║­ЪЈЙ	рѕ░рІЇ рІ│ріЋрѕх: рѕўрѕЃріерѕѕріЏ-рїЦрЅЂрѕГ рІерЅєрІ│ рЅђрѕѕрѕЮ
­ЪЋ║­ЪЈ┐	рѕ░рІЇ рІ│ріЋрѕх: рїЦрЅЂрѕГ рІерЅєрІ│ рЅђрѕѕрѕЮ
­ЪЉ»	рІерїЦріЋрЅИрѕЇ рїєрѕ« рІФрѕІрЅИрІЇ рѕ░рІјрЅй
­ЪЉ»РђЇРЎѓ№ИЈ	рІерїЦріЋрЅИрѕЇ рїєрѕ« рІФрѕІрЅИрІЇ рІѕріЋрІХрЅй
­ЪЉ»РђЇРЎѓ	рІерїЦріЋрЅИрѕЇ рїєрѕ« рІФрѕІрЅИрІЇ рІѕріЋрІХрЅй
­ЪЉ»РђЇРЎђ№ИЈ	рІерїЦріЋрЅИрѕЇ рїєрѕ« рІФрѕІрЅИрІЇ рѕ┤рЅХрЅй
­ЪЉ»РђЇРЎђ	рІерїЦріЋрЅИрѕЇ рїєрѕ« рІФрѕІрЅИрІЇ рѕ┤рЅХрЅй
­ЪДќ	рЅаріЦріЋрЇІрѕјрЅх ріГрЇЇрѕЇ рІЇрѕхрїЦ рІФрѕѕ рѕ░рІЇ
­ЪДќ­ЪЈ╗	рЅаріЦріЋрЇІрѕјрЅх ріГрЇЇрѕЅ рІЇрѕхрїЦ рІФрѕѕ рѕ░рІЇ: рЅђрѕІрѕЇ рІерЅєрІ│ рЅђрѕѕрѕЮ
­ЪДќ­ЪЈ╝	рЅаріЦріЋрЇІрѕјрЅх ріГрЇЇрѕЇ рІЇрѕхрїЦ рІФрѕѕ рѕ░рІЇрЇА рѕўрѕЃріерѕѕріЏ рЅђрѕІ рІФрѕѕ рІерЅєрІ│ рЅђрѕѕрѕЮ
­ЪДќ­ЪЈй	рЅаріЦріЋрЇІрѕјрЅх ріГрЇЇрѕЅ рІЇрѕхрїЦ рІФрѕѕ рѕ░рІЇ: рѕўрѕЃріерѕѕріЏ рІерЅєрІ│ рЅђрѕѕрѕЮ
­ЪДќ­ЪЈЙ	рЅаріЦріЋрЇІрѕјрЅх ріГрЇЇрѕЇ рІЇрѕхрїЦ рІФрѕѕ рѕ░рІЇрЇА рѕўрѕЃріерѕѕріЏ рЅђрѕІ рІФрѕѕ рІерЅєрІ│ рЅђрѕѕрѕЮ
­ЪДќ­ЪЈ┐	рЅаріЦріЋрЇІрѕјрЅх ріГрЇЇрѕЅ рІЇрѕхрїЦ рІФрѕѕ рѕ░рІЇ: рїЦрЅЂрѕГ рІерЅєрІ│ рЅђрѕѕрѕЮ
­ЪДќРђЇРЎђ№ИЈ	рЅаріЦріЋрЇІрѕјрЅх ріГрЇЇрѕЇ рІЇрѕхрїЦ рѕ┤рЅх
­ЪДќРђЇРЎђ	рЅаріЦріЋрЇІрѕјрЅх ріГрЇЇрѕЇ рІЇрѕхрїЦ рѕ┤рЅх
­ЪДќ­ЪЈ╗РђЇРЎђ№ИЈ	рѕ┤рЅх рЅаріЦріЋрЇІрѕјрЅх ріГрЇЇрѕЇ рІЇрѕхрїЦ: рЅђрѕІрѕЇ рІерЅєрІ│ рЅђрѕѕрѕЮ
­ЪДќ­ЪЈ╗РђЇРЎђ	рѕ┤рЅх рЅаріЦріЋрЇІрѕјрЅх ріГрЇЇрѕЇ рІЇрѕхрїЦ: рЅђрѕІрѕЇ рІерЅєрІ│ рЅђрѕѕрѕЮ
­ЪДќ­ЪЈ╝РђЇРЎђ№ИЈ	рѕ┤рЅх рЅаріЦріЋрЇІрѕјрЅх ріГрЇЇрѕЇ рІЇрѕхрїЦрЇА рѕўрѕЃріерѕѕріЏ рЅђрѕІ рІФрѕѕ рІерЅєрІ│ рЅђрѕѕрѕЮ
­ЪДќ­ЪЈ╝РђЇРЎђ	рѕ┤рЅх рЅаріЦріЋрЇІрѕјрЅх ріГрЇЇрѕЇ рІЇрѕхрїЦрЇА рѕўрѕЃріерѕѕріЏ рЅђрѕІ рІФрѕѕ рІерЅєрІ│ рЅђрѕѕрѕЮ
­ЪДќ­ЪЈйРђЇРЎђ№ИЈ	рѕ┤рЅх рЅаріЦріЋрЇІрѕјрЅх ріГрЇЇрѕЇ рІЇрѕхрїЦ: рѕўрѕЃріерѕѕріЏ рІерЅєрІ│ рЅђрѕѕрѕЮ
­ЪДќ­ЪЈйРђЇРЎђ	рѕ┤рЅх рЅаріЦріЋрЇІрѕјрЅх ріГрЇЇрѕЇ рІЇрѕхрїЦ: рѕўрѕЃріерѕѕріЏ рІерЅєрІ│ рЅђрѕѕрѕЮ
­ЪДќ­ЪЈЙРђЇРЎђ№ИЈ	рѕ┤рЅх рЅаріЦріЋрЇІрѕјрЅх ріГрЇЇрѕЇ рІЇрѕхрїЦрЇА рѕўрѕЃріерѕѕріЏ рЅђрѕІ рІФрѕѕ рІерЅєрІ│ рЅђрѕѕрѕЮ
­ЪДќ­ЪЈЙРђЇРЎђ	рѕ┤рЅх рЅаріЦріЋрЇІрѕјрЅх ріГрЇЇрѕЇ рІЇрѕхрїЦрЇА рѕўрѕЃріерѕѕріЏ рЅђрѕІ рІФрѕѕ рІерЅєрІ│ рЅђрѕѕрѕЮ
­ЪДќ­ЪЈ┐РђЇРЎђ№ИЈ	рѕ┤рЅх рЅаріЦріЋрЇІрѕјрЅх ріГрЇЇрѕЇ рІЇрѕхрїЦ: рїЦрЅЂрѕГ рІерЅєрІ│ рЅђрѕѕрѕЮ
­ЪДќ­ЪЈ┐РђЇРЎђ	рѕ┤рЅх рЅаріЦріЋрЇІрѕјрЅх ріГрЇЇрѕЇ рІЇрѕхрїЦ: рїЦрЅЂрѕГ рІерЅєрІ│ рЅђрѕѕрѕЮ
­ЪДќРђЇРЎѓ№ИЈ	рѕ░рІЇ рЅаріЦріЋрЇІрѕјрЅх ріГрЇЇрѕЇ рІЇрѕхрїЦ
­ЪДќРђЇРЎѓ	рѕ░рІЇ рЅаріЦріЋрЇІрѕјрЅх ріГрЇЇрѕЇ рІЇрѕхрїЦ
­ЪДќ­ЪЈ╗РђЇРЎѓ№ИЈ	рѕ░рІЇ рЅаріЦріЋрЇІрѕјрЅх ріГрЇЇрѕЇ рІЇрѕхрїЦ: рЅђрѕІрѕЇ рІерЅєрІ│ рЅђрѕѕрѕЮ
­ЪДќ­ЪЈ╗РђЇРЎѓ	рѕ░рІЇ рЅаріЦріЋрЇІрѕјрЅх ріГрЇЇрѕЇ рІЇрѕхрїЦ: рЅђрѕІрѕЇ рІерЅєрІ│ рЅђрѕѕрѕЮ
­ЪДќ­ЪЈ╝РђЇРЎѓ№ИЈ	рѕ░рІЇ рЅаріЦріЋрЇІрѕјрЅх ріГрЇЇрѕЇ рІЇрѕхрїЦ: рѕўрѕЃріерѕѕріЏ рЅђрѕІ рІФрѕѕ рІерЅєрІ│ рЅђрѕѕрѕЮ
­ЪДќ­ЪЈ╝РђЇРЎѓ	рѕ░рІЇ рЅаріЦріЋрЇІрѕјрЅх ріГрЇЇрѕЇ рІЇрѕхрїЦ: рѕўрѕЃріерѕѕріЏ рЅђрѕІ рІФрѕѕ рІерЅєрІ│ рЅђрѕѕрѕЮ
­ЪДќ­ЪЈйРђЇРЎѓ№ИЈ	рѕ░рІЇ рЅаріЦріЋрЇІрѕјрЅх ріГрЇЇрѕЇ рІЇрѕхрїЦ: рѕўрѕЃріерѕѕріЏ рІерЅєрІ│ рЅђрѕѕрѕЮ
­ЪДќ­ЪЈйРђЇРЎѓ	рѕ░рІЇ рЅаріЦріЋрЇІрѕјрЅх ріГрЇЇрѕЇ рІЇрѕхрїЦ: рѕўрѕЃріерѕѕріЏ рІерЅєрІ│ рЅђрѕѕрѕЮ
­ЪДќ­ЪЈЙРђЇРЎѓ№ИЈ	рѕ░рІЇ рЅаріЦріЋрЇІрѕјрЅх ріГрЇЇрѕЇ рІЇрѕхрїЦ: рѕўрѕЃріерѕѕріЏ-рїЦрЅЂрѕГ рІерЅєрІ│ рЅђрѕѕрѕЮ
­ЪДќ­ЪЈЙРђЇРЎѓ	рѕ░рІЇ рЅаріЦріЋрЇІрѕјрЅх ріГрЇЇрѕЇ рІЇрѕхрїЦ: рѕўрѕЃріерѕѕріЏ рЅђрѕІ рІФрѕѕ рІерЅєрІ│ рЅђрѕѕрѕЮ
­ЪДќ­ЪЈ┐РђЇРЎѓ№ИЈ	рѕ░рІЇ рЅаріЦріЋрЇІрѕјрЅх ріГрЇЇрѕЇ рІЇрѕхрїЦ: рїЦрЅЂрѕГ рІерЅєрІ│ рЅђрѕѕрѕЮ
­ЪДќ­ЪЈ┐РђЇРЎѓ	рѕ░рІЇ рЅаріЦріЋрЇІрѕјрЅх ріГрЇЇрѕЇ рІЇрѕхрїЦ: рїЦрЅЂрѕГ рІерЅєрІ│ рЅђрѕѕрѕЮ
­ЪДЌ	рѕ░рІЇ ріЦрІерІѕрїБ ріљрІЇрЇб
­ЪДЌ­ЪЈ╗	рІерѕџрІѕрїБ рѕ░рІЇрЇА рЅђрѕІрѕЇ рІерЅєрІ│ рЅђрѕѕрѕЮ
­ЪДЌ­ЪЈ╝	рІерѕџрІѕрїБ рѕ░рІЇрЇА рѕўрѕЃріерѕѕріЏ рЅђрѕІ рІФрѕѕ рІерЅєрІ│ рЅђрѕѕрѕЮ
­ЪДЌ­ЪЈй	рІерѕџрІѕрїБ рѕ░рІЇрЇА рѕўрѕЃріерѕѕріЏ рІерЅєрІ│ рЅђрѕѕрѕЮ
­ЪДЌ­ЪЈЙ	рІерѕџрІѕрїБ рѕ░рІЇрЇА рѕўрѕЃріерѕѕріЏ рЅђрѕІ рІФрѕѕ рІерЅєрІ│ рЅђрѕѕрѕЮ
­ЪДЌ­ЪЈ┐	рІерѕџрІѕрїБ рѕ░рІЇрЇА рїЦрЅЂрѕГ рІерЅєрІ│ рЅђрѕѕрѕЮ
­ЪДЌРђЇРЎђ№ИЈ	рѕ┤рЅх ріЦрІерІѕрїБрЅй
­ЪДЌРђЇРЎђ	рѕ┤рЅх ріЦрІерІѕрїБрЅй
­ЪДЌ­ЪЈ╗РђЇРЎђ№ИЈ	рѕ┤рЅх ріЦрІерІѕрїБрЅйрЇА рЅђрѕІрѕЇ рІерЅєрІ│ рЅђрѕѕрѕЮ
­ЪДЌ­ЪЈ╗РђЇРЎђ	рѕ┤рЅх ріЦрІерІѕрїБрЅйрЇА рЅђрѕІрѕЇ рІерЅєрІ│ рЅђрѕѕрѕЮ
­ЪДЌ­ЪЈ╝РђЇРЎђ№ИЈ	рѕ┤рЅх ріЦрІерІѕрїБрЅйрЇА рѕўрѕЃріерѕѕріЏ рЅђрѕІ рІФрѕѕ рІерЅєрІ│ рЅђрѕѕрѕЮ
­ЪДЌ­ЪЈ╝РђЇРЎђ	рѕ┤рЅх ріЦрІерІѕрїБрЅйрЇА рѕўрѕЃріерѕѕріЏ рЅђрѕІ рІФрѕѕ рІерЅєрІ│ рЅђрѕѕрѕЮ
­ЪДЌ­ЪЈйРђЇРЎђ№ИЈ	рѕ┤рЅх рѕўрІЇрїБрЅх: рѕўрѕЃріерѕѕріЏ рІерЅєрІ│ рЅђрѕѕрѕЮ
­ЪДЌ­ЪЈйРђЇРЎђ	рѕ┤рЅх рѕўрІЇрїБрЅх: рѕўрѕЃріерѕѕріЏ рІерЅєрІ│ рЅђрѕѕрѕЮ
­ЪДЌ­ЪЈЙРђЇРЎђ№ИЈ	рѕ┤рЅх ріЦрІерІѕрїБрЅйрЇА рѕўрѕЃріерѕѕріЏ рЅђрѕІ рІФрѕѕ рІерЅєрІ│ рЅђрѕѕрѕЮ
­ЪДЌ­ЪЈЙРђЇРЎђ	рѕ┤рЅх ріЦрІерІѕрїБрЅйрЇА рѕўрѕЃріерѕѕріЏ рЅђрѕІ рІФрѕѕ рІерЅєрІ│ рЅђрѕѕрѕЮ
­ЪДЌ­ЪЈ┐РђЇРЎђ№ИЈ	рѕ┤рЅх рѕўрІЇрїБрЅх: рїЦрЅЂрѕГ рІерЅєрІ│ рЅђрѕѕрѕЮ
­ЪДЌ­ЪЈ┐РђЇРЎђ	рѕ┤рЅх рѕўрІЇрїБрЅх: рїЦрЅЂрѕГ рІерЅєрІ│ рЅђрѕѕрѕЮ
­ЪДЌРђЇРЎѓ№ИЈ	рѕ░рІЇ рѕўрІЇрїБрЅх
­ЪДЌРђЇРЎѓ	рѕ░рІЇ рѕўрІЇрїБрЅх
­ЪДЌ­ЪЈ╗РђЇРЎѓ№ИЈ	рѕ░рІЇ рѕўрІЇрїБрЅх: рЅђрѕІрѕЇ рІерЅєрІ│ рЅђрѕѕрѕЮ
­ЪДЌ­ЪЈ╗РђЇРЎѓ	рѕ░рІЇ рѕўрІЇрїБрЅх: рЅђрѕІрѕЇ рІерЅєрІ│ рЅђрѕѕрѕЮ
­ЪДЌ­ЪЈ╝РђЇРЎѓ№ИЈ	рѕ░рІЇ ріЦрІерІѕрїБрѕЁрЇА рѕўрѕЃріерѕѕріЏ рЅђрѕІ рІФрѕѕ рІерЅєрІ│ рЅђрѕѕрѕЮ
­ЪДЌ­ЪЈ╝РђЇРЎѓ	рѕ░рІЇ ріЦрІерІѕрїБрѕЁрЇА рѕўрѕЃріерѕѕріЏ рЅђрѕІ рІФрѕѕ рІерЅєрІ│ рЅђрѕѕрѕЮ
­ЪДЌ­ЪЈйРђЇРЎѓ№ИЈ	рѕ░рІЇ рѕўрІЇрїБрЅх: рѕўрѕЃріерѕѕріЏ рІерЅєрІ│ рЅђрѕѕрѕЮ
­ЪДЌ­ЪЈйРђЇРЎѓ	рѕ░рІЇ рѕўрІЇрїБрЅх: рѕўрѕЃріерѕѕріЏ рІерЅєрІ│ рЅђрѕѕрѕЮ
­ЪДЌ­ЪЈЙРђЇРЎѓ№ИЈ	рѕ░рІЇ ріЦрІерІѕрїБрѕЁрЇА рѕўрѕЃріерѕѕріЏ рЅђрѕІ рІФрѕѕ рІерЅєрІ│ рЅђрѕѕрѕЮ
­ЪДЌ­ЪЈЙРђЇРЎѓ	рѕ░рІЇ ріЦрІерІѕрїБрѕЁрЇА рѕўрѕЃріерѕѕріЏ рЅђрѕІ рІФрѕѕ рІерЅєрІ│ рЅђрѕѕрѕЮ
­ЪДЌ­ЪЈ┐РђЇРЎѓ№ИЈ	рѕ░рІЇ рѕўрІЇрїБрЅх: рїЦрЅЂрѕГ рІерЅєрІ│ рЅђрѕѕрѕЮ
­ЪДЌ­ЪЈ┐РђЇРЎѓ	рѕ░рІЇ рѕўрІЇрїБрЅх: рїЦрЅЂрѕГ рІерЅєрІ│ рЅђрѕѕрѕЮ
­ЪДў	рЅарѕјрЅ░рѕх рЅдрЅ│ рѕІрІГ рІФрѕѕ рѕ░рІЇ
­ЪДў­ЪЈ╗	рЅарѕјрЅ░рѕх рЅдрЅ│ рѕІрІГ рІФрѕѕ рѕ░рІЇ: рЅђрѕІрѕЇ рІерЅєрІ│ рЅђрѕѕрѕЮ
­ЪДў­ЪЈ╝	рЅарѕјрЅ░рѕх рЅдрЅ│ рѕІрІГ рІФрѕѕ рѕ░рІЇ: рѕўрѕЃріерѕѕріЏ рЅђрѕІ рІФрѕѕ рІерЅєрІ│ рЅђрѕѕрѕЮ
­ЪДў­ЪЈй	рЅарѕјрЅ░рѕх рЅдрЅ│ рѕІрІГ рІФрѕѕ рѕ░рІЇ: рѕўрѕЃріерѕѕріЏ рІерЅєрІ│ рЅђрѕѕрѕЮ
­ЪДў­ЪЈЙ	рЅарѕјрЅ░рѕх рЅдрЅ│ рѕІрІГ рІФрѕѕ рѕ░рІЇ: рѕўрѕЃріерѕѕріЏ-рїЦрЅЂрѕГ рІерЅєрІ│ рЅђрѕѕрѕЮ
­ЪДў­ЪЈ┐	рЅарѕјрЅ░рѕх рЅдрЅ│ рѕІрІГ рІФрѕѕ рѕ░рІЇ: рїЦрЅЂрѕГ рІерЅєрІ│ рЅђрѕѕрѕЮ
­ЪДўРђЇРЎђ№ИЈ	рЅарѕјрЅ░рѕх ріарЅђрѕЏрѕўрїЦ рѕІрІГ рІФрѕѕрЅй рѕ┤рЅх
­ЪДўРђЇРЎђ	рЅарѕјрЅ░рѕх ріарЅђрѕЏрѕўрїЦ рѕІрІГ рІФрѕѕрЅй рѕ┤рЅх
­ЪДў­ЪЈ╗РђЇРЎђ№ИЈ	рЅарѕјрЅ░рѕх ріарЅђрѕЏрѕўрїЦ рѕІрІГ рІФрѕѕрЅй рѕ┤рЅх: рЅђрѕІрѕЇ рІерЅєрІ│ рЅђрѕѕрѕЮ
­ЪДў­ЪЈ╗РђЇРЎђ	рЅарѕјрЅ░рѕх ріарЅђрѕЏрѕўрїЦ рѕІрІГ рІФрѕѕрЅй рѕ┤рЅх: рЅђрѕІрѕЇ рІерЅєрІ│ рЅђрѕѕрѕЮ
­ЪДў­ЪЈ╝РђЇРЎђ№ИЈ	рЅарѕјрЅ░рѕх ріарЅђрѕЏрѕўрїЦ рѕІрІГ рІФрѕѕрЅй рѕ┤рЅх: рѕўрѕЃріерѕѕріЏ рЅђрѕІ рІФрѕѕ рІерЅєрІ│ рЅђрѕѕрѕЮ
­ЪДў­ЪЈ╝РђЇРЎђ	рЅарѕјрЅ░рѕх ріарЅђрѕЏрѕўрїЦ рѕІрІГ рІФрѕѕрЅй рѕ┤рЅх: рѕўрѕЃріерѕѕріЏ рЅђрѕІ рІФрѕѕ рІерЅєрІ│ рЅђрѕѕрѕЮ
­ЪДў­ЪЈйРђЇРЎђ№ИЈ	рЅарѕјрЅ░рѕх ріарЅђрѕЏрѕўрїЦ рѕІрІГ рІФрѕѕрЅй рѕ┤рЅх: рѕўрѕЃріерѕѕріЏ рІерЅєрІ│ рЅђрѕѕрѕЮ
­ЪДў­ЪЈйРђЇРЎђ	рЅарѕјрЅ░рѕх ріарЅђрѕЏрѕўрїЦ рѕІрІГ рІФрѕѕрЅй рѕ┤рЅх: рѕўрѕЃріерѕѕріЏ рІерЅєрІ│ рЅђрѕѕрѕЮ
­ЪДў­ЪЈЙРђЇРЎђ№ИЈ	рѕ┤рЅх рЅарѕјрЅ░рѕх ріарЅђрѕЏрѕўрїЦ: рѕўрѕЃріерѕѕріЏ-рїЦрЅЂрѕГ рІерЅєрІ│ рЅђрѕѕрѕЮ
­ЪДў­ЪЈЙРђЇРЎђ	рѕ┤рЅх рЅарѕјрЅ░рѕх ріарЅђрѕЏрѕўрїЦ: рѕўрѕЃріерѕѕріЏ-рїЦрЅЂрѕГ рІерЅєрІ│ рЅђрѕѕрѕЮ
­ЪДў­ЪЈ┐РђЇРЎђ№ИЈ	рЅарѕјрЅ░рѕх ріарЅђрѕЏрѕўрїЦ рѕІрІГ рІФрѕѕрЅй рѕ┤рЅх: рїЦрЅЂрѕГ рІерЅєрІ│ рЅђрѕѕрѕЮ
­ЪДў­ЪЈ┐РђЇРЎђ	рЅарѕјрЅ░рѕх ріарЅђрѕЏрѕўрїЦ рѕІрІГ рІФрѕѕрЅй рѕ┤рЅх: рїЦрЅЂрѕГ рІерЅєрІ│ рЅђрѕѕрѕЮ
­ЪДўРђЇРЎѓ№ИЈ	рѕ░рІЇ рЅарѕјрЅ░рѕх рЅдрЅ│ рѕІрІГ
­ЪДўРђЇРЎѓ	рѕ░рІЇ рЅарѕјрЅ░рѕх рЅдрЅ│ рѕІрІГ
­ЪДў­ЪЈ╗РђЇРЎѓ№ИЈ	рѕ░рІЇ рЅарѕјрЅ░рѕх ріарЅђрѕЏрѕўрїЦ: рЅђрѕІрѕЇ рІерЅєрІ│ рЅђрѕѕрѕЮ
­ЪДў­ЪЈ╗РђЇРЎѓ	рѕ░рІЇ рЅарѕјрЅ░рѕх ріарЅђрѕЏрѕўрїЦ: рЅђрѕІрѕЇ рІерЅєрІ│ рЅђрѕѕрѕЮ
­ЪДў­ЪЈ╝РђЇРЎѓ№ИЈ	рѕ░рІЇ рЅарѕјрЅ░рѕх ріарЅђрѕЏрѕўрїЦ: рѕўрѕЃріерѕѕріЏ рЅђрѕІ рІФрѕѕ рІерЅєрІ│ рЅђрѕѕрѕЮ
­ЪДў­ЪЈ╝РђЇРЎѓ	рѕ░рІЇ рЅарѕјрЅ░рѕх ріарЅђрѕЏрѕўрїЦ: рѕўрѕЃріерѕѕріЏ рЅђрѕІ рІФрѕѕ рІерЅєрІ│ рЅђрѕѕрѕЮ
­ЪДў­ЪЈйРђЇРЎѓ№ИЈ	рѕ░рІЇ рЅарѕјрЅ░рѕх ріарЅђрѕЏрѕўрїЦ: рѕўрѕЃріерѕѕріЏ рІерЅєрІ│ рЅђрѕѕрѕЮ
­ЪДў­ЪЈйРђЇРЎѓ	рѕ░рІЇ рЅарѕјрЅ░рѕх ріарЅђрѕЏрѕўрїЦ: рѕўрѕЃріерѕѕріЏ рІерЅєрІ│ рЅђрѕѕрѕЮ
­ЪДў­ЪЈЙРђЇРЎѓ№ИЈ	рѕ░рІЇ рЅарѕјрЅ░рѕх ріарЅђрѕЏрѕўрїЦ: рѕўрѕЃріерѕѕріЏ-рїЦрЅЂрѕГ рІерЅєрІ│ рЅђрѕѕрѕЮ
­ЪДў­ЪЈЙРђЇРЎѓ	рѕ░рІЇ рЅарѕјрЅ░рѕх ріарЅђрѕЏрѕўрїЦ: рѕўрѕЃріерѕѕріЏ-рїЦрЅЂрѕГ рІерЅєрІ│ рЅђрѕѕрѕЮ
­ЪДў­ЪЈ┐РђЇРЎѓ№ИЈ	рѕ░рІЇ рЅарѕјрЅ░рѕх ріарЅђрѕЏрѕўрїЦ: рїЦрЅЂрѕГ рІерЅєрІ│ рЅђрѕѕрѕЮ
­ЪДў­ЪЈ┐РђЇРЎѓ	рѕ░рІЇ рЅарѕјрЅ░рѕх ріарЅђрѕЏрѕўрїЦ: рїЦрЅЂрѕГ рІерЅєрІ│ рЅђрѕѕрѕЮ
­ЪЏђ	рїѕрѕІрІЇріЋ рІерѕџрЅ│рїарЅЦ рѕ░рІЇ
­ЪЏђ­ЪЈ╗	рїѕрѕІрІЇріЋ рІерѕџрЅ│рїарЅЦ рѕ░рІЇрЇА рЅђрѕІрѕЇ рІерЅєрІ│ рЅђрѕѕрѕЮ
­ЪЏђ­ЪЈ╝	рїѕрѕІрІЇріЋ рІерѕџрЅ│рїарЅЦ рѕ░рІЇрЇА рѕўрѕЃріерѕѕріЏ рЅђрѕІ рІФрѕѕ рІерЅєрІ│ рЅђрѕѕрѕЮ
­ЪЏђ­ЪЈй	рїѕрѕІрІЇріЋ рІерѕџрЅ│рїарЅЦ рѕ░рІЇрЇА рѕўрѕЃріерѕѕріЏ рІерЅєрІ│ рЅђрѕѕрѕЮ
­ЪЏђ­ЪЈЙ	рїѕрѕІрІЇріЋ рІерѕџрЅ│рїарЅЦ рѕ░рІЇрЇА рѕўрѕЃріерѕѕріЏ рЅђрѕІ рІФрѕѕ рІерЅєрІ│ рЅђрѕѕрѕЮ
­ЪЏђ­ЪЈ┐	рІерѕџрЅ│рїарЅЦ рѕ░рІЇ: рїЦрЅЂрѕГ рІерЅєрІ│ рЅђрѕѕрѕЮ
­ЪЏї	ріарѕЇрїІ рѕІрІГ рІФрѕѕ рѕ░рІЇ
­ЪЏї­ЪЈ╗	ріарѕЇрїІ рѕІрІГ рІФрѕѕ рѕ░рІЇрЇА рЅђрѕІрѕЇ рІерЅєрІ│ рЅђрѕѕрѕЮ
­ЪЏї­ЪЈ╝	ріарѕЇрїІ рѕІрІГ рІФрѕѕ рѕ░рІЇрЇА рѕўрѕЃріерѕѕріЏ рЅђрѕІ рІФрѕѕ рІерЅєрІ│ рЅђрѕѕрѕЮ
­ЪЏї­ЪЈй	ріарѕЇрїІ рѕІрІГ рІФрѕѕ рѕ░рІЇрЇА рѕўрѕЃріерѕѕріЏ рІерЅєрІ│ рЅђрѕѕрѕЮ
­ЪЏї­ЪЈЙ	ріарѕЇрїІ рѕІрІГ рІФрѕѕ рѕ░рІЇрЇА рѕўрѕЃріерѕѕріЏ рЅђрѕІ рІФрѕѕ рІерЅєрІ│ рЅђрѕѕрѕЮ
­ЪЏї­ЪЈ┐	рЅаріарѕЇрїІ рѕІрІГ рІФрѕѕ рѕ░рІЇ: рїЦрЅЂрѕГ рІерЅєрІ│ рЅђрѕѕрѕЮ
­ЪЋ┤№ИЈ	рїЅрІ│рІЕріЋ рІерѕѕрЅарѕ░ рѕ░рІЇ
­ЪЋ┤	рїЅрІ│рІЕріЋ рІерѕѕрЅарѕ░ рѕ░рІЇ
­ЪЋ┤­ЪЈ╗	рѕЇрЅЦрѕх рІерѕѕрЅарѕ░ рѕ░рІЇ рѕїрЅфрЅ▓ріЋрїЇрЇА рЅђрѕІрѕЇ рІерЅєрІ│ рЅђрѕѕрѕЮ
­ЪЋ┤­ЪЈ╝	рѕ▒рЅх рІерѕѕрЅарѕ░ рѕ░рІЇрЇА рѕўрѕЃріерѕѕріЏ рЅђрѕІ рІФрѕѕ рІерЅєрІ│ рЅђрѕѕрѕЮ
­ЪЋ┤­ЪЈй	рѕ▒рЅх рІерѕѕрЅарѕ░ рѕ░рІЇрЇА рѕўрѕЃріерѕѕріЏ рІерЅєрІ│ рЅђрѕѕрѕЮ
­ЪЋ┤­ЪЈЙ	рѕ▒рЅх рІерѕѕрЅарѕ░ рѕ░рІЇрЇА рѕўрѕЃріерѕѕріЏ рЅђрѕІ рІФрѕѕ рІерЅєрІ│ рЅђрѕѕрѕЮ
­ЪЋ┤­ЪЈ┐	рѕЇрЅЦрѕх рІерѕѕрЅарѕ░ рѕ░рІЇ рѕїрЅфрЅ▓ріЋрїЇрЇА рїЦрЅЂрѕГ рІерЅєрІ│ рЅђрѕѕрѕЮ
­ЪЌБ№ИЈ	рІерѕџріЊрїѕрѕГ рїГріЋрЅЁрѕІрЅх
­ЪЌБ	рІерѕџріЊрїѕрѕГ рїГріЋрЅЁрѕІрЅх
­ЪЉц	рЅа silhouette рІЇрѕхрїЦ рІ░рѕерЅх
­ЪЉЦ	рЅа silhouette рІЇрѕхрїЦ busts
­Ъц║	рѕ░рІЇ ріарїЦрѕГ
­ЪЈЄ	рІерЇѕрѕерѕх ріЦрѕйрЅЁрІхрѕЮрІхрѕЮ
­ЪЈЄ­ЪЈ╗	рІерЇѕрѕерѕх ріЦрѕйрЅЁрІхрѕЮрІхрѕЮ: рЅђрѕІрѕЇ рІерЅєрІ│ рЅђрѕѕрѕЮ
­ЪЈЄ­ЪЈ╝	рІерЇѕрѕерѕх ріЦрѕйрЅЁрІхрѕЮрІхрѕЮ: рѕўрѕЃріерѕѕріЏ рЅђрѕІ рІФрѕѕ рІерЅєрІ│ рЅђрѕѕрѕЮ
­ЪЈЄ­ЪЈй	рІерЇѕрѕерѕх ріЦрѕйрЅЁрІхрѕЮрІхрѕЮ: рѕўрѕЃріерѕѕріЏ рІерЅєрІ│ рЅђрѕѕрѕЮ
­ЪЈЄ­ЪЈЙ	рІерЇѕрѕерѕх ріЦрѕйрЅЁрІхрѕЮрІхрѕЮ: рѕўрѕЃріерѕѕріЏ-рїЦрЅЂрѕГ рІерЅєрІ│ рЅђрѕѕрѕЮ
­ЪЈЄ­ЪЈ┐	рІерЇѕрѕерѕх ріЦрѕйрЅЁрІхрѕЮрІхрѕЮ: рїЦрЅЂрѕГ рІерЅєрІ│ рЅђрѕѕрѕЮ
РЏи№ИЈ	рІерЅарѕерІХ рѕўріЋрѕИрѕФрЅ░рЅ╗
РЏи	рІерЅарѕерІХ рѕўріЋрѕИрѕФрЅ░рЅ╗
­ЪЈѓ	рІерЅарѕерІХ рЅ░ріЋрѕИрѕФрЅ│рЅй
­ЪЈѓ­ЪЈ╗	рІерЅарѕерІХ рЅ░ріЋрѕИрѕФрЅ│рЅй: рЅђрѕІрѕЇ рІерЅєрІ│ рЅђрѕѕрѕЮ
­ЪЈѓ­ЪЈ╝	рІерЅарѕерІХ рЅ░ріЋрѕИрѕФрЅ│рЅй: рѕўрѕЃріерѕѕріЏ-рЅђрѕІрѕЇ рІерЅєрІ│ рЅђрѕѕрѕЮ
­ЪЈѓ­ЪЈй	рІерЅарѕерІХ рЅ░ріЋрѕИрѕФрЅ│рЅй: рѕўрѕЃріерѕѕріЏ рІерЅєрІ│ рЅђрѕѕрѕЮ
­ЪЈѓ­ЪЈЙ	snowboarder: рѕўрѕЃріерѕѕріЏ-рїЦрЅЂрѕГ рІерЅєрІ│ рЅђрѕѕрѕЮ
­ЪЈѓ­ЪЈ┐	рІерЅарѕерІХ рЅ░ріЋрѕИрѕФрЅ│рЅй: рїЦрЅЂрѕГ рІерЅєрІ│ рЅђрѕѕрѕЮ
­ЪЈї№ИЈ	рѕ░рІЇ рїјрѕЇрЇЇ рѕўрїФрІѕрЅх
­ЪЈї	рѕ░рІЇ рїјрѕЇрЇЇ рѕўрїФрІѕрЅх
­ЪЈї­ЪЈ╗	рѕ░рІЇ рїјрѕЇрЇЇ рѕўрїФрІѕрЅхрЇА рЅђрѕІрѕЇ рІерЅєрІ│ рЅђрѕѕрѕЮ
­ЪЈї­ЪЈ╝	рѕ░рІЇ рїјрѕЇрЇЇ рѕўрїФрІѕрЅхрЇА рѕўрѕЃріерѕѕріЏ рЅђрѕІ рІФрѕѕ рІерЅєрІ│ рЅђрѕѕрѕЮ
­ЪЈї­ЪЈй	рѕ░рІЇ рїјрѕЇрЇЇ рѕўрїФрІѕрЅхрЇА рѕўрѕЃріерѕѕріЏ рІерЅєрІ│ рЅђрѕѕрѕЮ
­ЪЈї­ЪЈЙ	рѕ░рІЇ рїјрѕЇрЇЇ рѕўрїФрІѕрЅхрЇА рѕўрѕЃріерѕѕріЏ рЅђрѕІ рІФрѕѕ рІерЅєрІ│ рЅђрѕѕрѕЮ
­ЪЈї­ЪЈ┐	рѕ░рІЇ рїјрѕЇрЇЇ рѕўрїФрІѕрЅхрЇА рїЦрЅЂрѕГ рІерЅєрІ│ рЅђрѕѕрѕЮ
­ЪЈї№ИЈРђЇРЎѓ№ИЈ	рѕ░рІЇ рїјрѕЇрЇЇ рѕўрїФрІѕрЅх
­ЪЈїРђЇРЎѓ№ИЈ	рІѕріЋрІх рїјрѕЇрЇЇ рѕўрїФрІѕрЅх
­ЪЈї№ИЈРђЇРЎѓ	рІѕріЋрІх рїјрѕЇрЇЇ рѕўрїФрІѕрЅх
­ЪЈїРђЇРЎѓ	рѕ░рІЇ рїјрѕЇрЇЇ рѕўрїФрІѕрЅх
­ЪЈї­ЪЈ╗РђЇРЎѓ№ИЈ	рѕ░рІЇ рїјрѕЇрЇЇ: рЅђрѕІрѕЇ рІерЅєрІ│ рЅђрѕѕрѕЮ
­ЪЈї­ЪЈ╗РђЇРЎѓ	рѕ░рІЇ рїјрѕЇрЇЇ: рЅђрѕІрѕЇ рІерЅєрІ│ рЅђрѕѕрѕЮ
­ЪЈї­ЪЈ╝РђЇРЎѓ№ИЈ	рІѕріЋрІх рїјрѕЇрЇЇ: рѕўрѕЃріерѕѕріЏ рЅђрѕІ рІФрѕѕ рІерЅєрІ│ рЅђрѕѕрѕЮ
­ЪЈї­ЪЈ╝РђЇРЎѓ	рІѕріЋрІх рїјрѕЇрЇЇ: рѕўрѕЃріерѕѕріЏ рЅђрѕІ рІФрѕѕ рІерЅєрІ│ рЅђрѕѕрѕЮ
­ЪЈї­ЪЈйРђЇРЎѓ№ИЈ	рІѕріЋрІх рїјрѕЇрЇЇ: рѕўрѕЃріерѕѕріЏ рІерЅєрІ│ рЅђрѕѕрѕЮ
­ЪЈї­ЪЈйРђЇРЎѓ	рІѕріЋрІх рїјрѕЇрЇЇ: рѕўрѕЃріерѕѕріЏ рІерЅєрІ│ рЅђрѕѕрѕЮ
­ЪЈї­ЪЈЙРђЇРЎѓ№ИЈ	рІѕріЋрІх рїјрѕЇрЇЇ рѕўрїФрІѕрЅхрЇА рѕўрѕЃріерѕѕріЏ рЅђрѕІ рІФрѕѕ рІерЅєрІ│ рЅђрѕѕрѕЮ
­ЪЈї­ЪЈЙРђЇРЎѓ	рІѕріЋрІх рїјрѕЇрЇЇ рѕўрїФрІѕрЅхрЇА рѕўрѕЃріерѕѕріЏ рЅђрѕІ рІФрѕѕ рІерЅєрІ│ рЅђрѕѕрѕЮ
­ЪЈї­ЪЈ┐РђЇРЎѓ№ИЈ	рѕ░рІЇ рїјрѕЇрЇЇ: рїЦрЅЂрѕГ рІерЅєрІ│ рЅђрѕѕрѕЮ
­ЪЈї­ЪЈ┐РђЇРЎѓ	рѕ░рІЇ рїјрѕЇрЇЇ: рїЦрЅЂрѕГ рІерЅєрІ│ рЅђрѕѕрѕЮ
­ЪЈї№ИЈРђЇРЎђ№ИЈ	рѕ┤рЅх рїјрѕЇрЇЇ рѕўрїФрІѕрЅх
­ЪЈїРђЇРЎђ№ИЈ	рѕ┤рЅх рїјрѕЇрЇЇ рѕўрїФрІѕрЅх
­ЪЈї№ИЈРђЇРЎђ	рѕ┤рЅх рїјрѕЇрЇЇ рѕўрїФрІѕрЅх
­ЪЈїРђЇРЎђ	рѕ┤рЅх рїјрѕЇрЇЇ рѕўрїФрІѕрЅх
­ЪЈї­ЪЈ╗РђЇРЎђ№ИЈ	рѕ┤рЅх рїјрѕЇрЇЇ рѕўрїФрІѕрЅхрЇА рЅђрѕІрѕЇ рІерЅєрІ│ рЅђрѕѕрѕЮ
­ЪЈї­ЪЈ╗РђЇРЎђ	рѕ┤рЅх рїјрѕЇрЇЇ рѕўрїФрІѕрЅхрЇА рЅђрѕІрѕЇ рІерЅєрІ│ рЅђрѕѕрѕЮ
­ЪЈї­ЪЈ╝РђЇРЎђ№ИЈ	рѕ┤рЅх рїјрѕЇрЇЇ рѕўрїФрІѕрЅхрЇА рѕўрѕЃріерѕѕріЏ рЅђрѕІ рІФрѕѕ рІерЅєрІ│ рЅђрѕѕрѕЮ
­ЪЈї­ЪЈ╝РђЇРЎђ	рѕ┤рЅх рїјрѕЇрЇЇ рѕўрїФрІѕрЅхрЇА рѕўрѕЃріерѕѕріЏ рЅђрѕІ рІФрѕѕ рІерЅєрІ│ рЅђрѕѕрѕЮ
­ЪЈї­ЪЈйРђЇРЎђ№ИЈ	рѕ┤рЅх рїјрѕЇрЇЇ рѕўрїФрІѕрЅх: рѕўрѕЃріерѕѕріЏ рІерЅєрІ│ рЅђрѕѕрѕЮ
­ЪЈї­ЪЈйРђЇРЎђ	рѕ┤рЅх рїјрѕЇрЇЇ рѕўрїФрІѕрЅх: рѕўрѕЃріерѕѕріЏ рІерЅєрІ│ рЅђрѕѕрѕЮ
­ЪЈї­ЪЈЙРђЇРЎђ№ИЈ	рѕ┤рЅх рїјрѕЇрЇЇ рѕўрїФрІѕрЅхрЇА рѕўрѕЃріерѕѕріЏ рЅђрѕІ рІФрѕѕ рІерЅєрІ│ рЅђрѕѕрѕЮ
­ЪЈї­ЪЈЙРђЇРЎђ	рѕ┤рЅх рїјрѕЇрЇЇ рѕўрїФрІѕрЅхрЇА рѕўрѕЃріерѕѕріЏ рЅђрѕІ рІФрѕѕ рІерЅєрІ│ рЅђрѕѕрѕЮ
­ЪЈї­ЪЈ┐РђЇРЎђ№ИЈ	рѕ┤рЅх рїјрѕЇрЇЇ рѕўрїФрІѕрЅх: рїЦрЅЂрѕГ рІерЅєрІ│ рЅђрѕѕрѕЮ
­ЪЈї­ЪЈ┐РђЇРЎђ	рѕ┤рЅх рїјрѕЇрЇЇ рѕўрїФрІѕрЅх: рїЦрЅЂрѕГ рІерЅєрІ│ рЅђрѕѕрѕЮ
­ЪЈё	рѕ░рІЇ рѕ░рѕГрЇіріЋрїЇ
­ЪЈё­ЪЈ╗	рѕ░рІЇ рѕ░рѕГрЇіріЋрїЇрЇА рЅђрѕІрѕЇ рІерЅєрІ│ рЅђрѕѕрѕЮ
­ЪЈё­ЪЈ╝	рѕ░рІЇ рѕ░рѕГрЇіріЋрїЇрЇА рѕўрѕЃріерѕѕріЏ рЅђрѕІ рІФрѕѕ рІерЅєрІ│ рЅђрѕѕрѕЮ
­ЪЈё­ЪЈй	рѕ░рІЇ рѕ░рѕГрЇіріЋрїЇрЇА рѕўрѕЃріерѕѕріЏ рІерЅєрІ│ рЅђрѕѕрѕЮ
­ЪЈё­ЪЈЙ	рѕ░рІЇ рѕ░рѕГрЇіріЋрїЇрЇА рѕўрѕЃріерѕѕріЏ рЅђрѕІ рІФрѕѕ рІерЅєрІ│ рЅђрѕѕрѕЮ
­ЪЈё­ЪЈ┐	рѕ░рІЇ рѕ░рѕГрЇіріЋрїЇрЇА рїЦрЅЂрѕГ рІерЅєрІ│ рЅђрѕѕрѕЮ
­ЪЈёРђЇРЎѓ№ИЈ	рѕ░рІЇ рѕ░рѕГрЇіріЋрїЇ
­ЪЈёРђЇРЎѓ	рѕ░рІЇ рѕ░рѕГрЇіріЋрїЇ
­ЪЈё­ЪЈ╗РђЇРЎѓ№ИЈ	рѕ░рІЇ рѕ░рѕГрЇіріЋрїЇ: рЅђрѕІрѕЇ рІерЅєрІ│ рЅђрѕѕрѕЮ
­ЪЈё­ЪЈ╗РђЇРЎѓ	рѕ░рІЇ рѕ░рѕГрЇіріЋрїЇ: рЅђрѕІрѕЇ рІерЅєрІ│ рЅђрѕѕрѕЮ
­ЪЈё­ЪЈ╝РђЇРЎѓ№ИЈ	рѕ░рІЇ рѕ░рѕГрЇіріЋрїЇрЇА рѕўрѕЃріерѕѕріЏ рЅђрѕІ рІФрѕѕ рІерЅєрІ│ рЅђрѕѕрѕЮ
­ЪЈё­ЪЈ╝РђЇРЎѓ	рѕ░рІЇ рѕ░рѕГрЇіріЋрїЇрЇА рѕўрѕЃріерѕѕріЏ рЅђрѕІ рІФрѕѕ рІерЅєрІ│ рЅђрѕѕрѕЮ
­ЪЈё­ЪЈйРђЇРЎѓ№ИЈ	рѕ░рІЇ рѕ░рѕГрЇіріЋрїЇ: рѕўрѕЃріерѕѕріЏ рІерЅєрІ│ рЅђрѕѕрѕЮ
­ЪЈё­ЪЈйРђЇРЎѓ	рѕ░рІЇ рѕ░рѕГрЇіріЋрїЇ: рѕўрѕЃріерѕѕріЏ рІерЅєрІ│ рЅђрѕѕрѕЮ
­ЪЈё­ЪЈЙРђЇРЎѓ№ИЈ	рѕ░рІЇ рѕ░рѕГрЇіріЋрїЇрЇА рѕўрѕЃріерѕѕріЏ рЅђрѕІ рІФрѕѕ рІерЅєрІ│ рЅђрѕѕрѕЮ
­ЪЈё­ЪЈЙРђЇРЎѓ	рѕ░рІЇ рѕ░рѕГрЇіріЋрїЇрЇА рѕўрѕЃріерѕѕріЏ рЅђрѕІ рІФрѕѕ рІерЅєрІ│ рЅђрѕѕрѕЮ
­ЪЈё­ЪЈ┐РђЇРЎѓ№ИЈ	рѕ░рІЇ рѕ░рѕГрЇіріЋрїЇ: рїЦрЅЂрѕГ рІерЅєрІ│ рЅђрѕѕрѕЮ
­ЪЈё­ЪЈ┐РђЇРЎѓ	рѕ░рІЇ рѕ░рѕГрЇіріЋрїЇ: рїЦрЅЂрѕГ рІерЅєрІ│ рЅђрѕѕрѕЮ
­ЪЈёРђЇРЎђ№ИЈ	рѕ┤рЅх рЅ░ріЋрѕ│рЇІрЇі
­ЪЈёРђЇРЎђ	рѕ┤рЅх рЅ░ріЋрѕ│рЇІрЇі
­ЪЈё­ЪЈ╗РђЇРЎђ№ИЈ	рѕ┤рЅх рѕ░рѕГрЇіріЋрїЇрЇА рЅђрѕІрѕЇ рІерЅєрІ│ рЅђрѕѕрѕЮ
­ЪЈё­ЪЈ╗РђЇРЎђ	рѕ┤рЅх рѕ░рѕГрЇіріЋрїЇрЇА рЅђрѕІрѕЇ рІерЅєрІ│ рЅђрѕѕрѕЮ
­ЪЈё­ЪЈ╝РђЇРЎђ№ИЈ	рѕ┤рЅх рѕ░рѕГрЇіріЋрїЇрЇА рѕўрѕЃріерѕѕріЏ рЅђрѕІ рІФрѕѕ рІерЅєрІ│ рЅђрѕѕрѕЮ
­ЪЈё­ЪЈ╝РђЇРЎђ	рѕ┤рЅх рѕ░рѕГрЇіріЋрїЇрЇА рѕўрѕЃріерѕѕріЏ рЅђрѕІ рІФрѕѕ рІерЅєрІ│ рЅђрѕѕрѕЮ
­ЪЈё­ЪЈйРђЇРЎђ№ИЈ	рѕ┤рЅх рѕ░рѕГрЇіріЋрїЇ: рѕўрѕЃріерѕѕріЏ рІерЅєрІ│ рЅђрѕѕрѕЮ
­ЪЈё­ЪЈйРђЇРЎђ	рѕ┤рЅх рѕ░рѕГрЇіріЋрїЇ: рѕўрѕЃріерѕѕріЏ рІерЅєрІ│ рЅђрѕѕрѕЮ
­ЪЈё­ЪЈЙРђЇРЎђ№ИЈ	рѕ┤рЅх рѕ░рѕГрЇіріЋрїЇрЇА рѕўрѕЃріерѕѕріЏ рЅђрѕІ рІФрѕѕ рІерЅєрІ│ рЅђрѕѕрѕЮ
­ЪЈё­ЪЈЙРђЇРЎђ	рѕ┤рЅх рѕ░рѕГрЇіріЋрїЇрЇА рѕўрѕЃріерѕѕріЏ рЅђрѕІ рІФрѕѕ рІерЅєрІ│ рЅђрѕѕрѕЮ
­ЪЈё­ЪЈ┐РђЇРЎђ№ИЈ	рѕ┤рЅх рѕ░рѕГрЇіріЋрїЇ: рїЦрЅЂрѕГ рІерЅєрІ│ рЅђрѕѕрѕЮ
­ЪЈё­ЪЈ┐РђЇРЎђ	рѕ┤рЅх рѕ░рѕГрЇіріЋрїЇ: рїЦрЅЂрѕГ рІерЅєрІ│ рЅђрѕѕрѕЮ
­ЪџБ	рїђрѕЇрЅБ рІерѕџрЅђрІЮрЇЇ рѕ░рІЇ
­ЪџБ­ЪЈ╗	рїђрѕЇрЅБ рІерѕџрЅђрІЮрЇЇ рѕ░рІЇрЇА рЅђрѕІрѕЇ рІерЅєрІ│ рЅђрѕѕрѕЮ
­ЪџБ­ЪЈ╝	рїђрѕЇрЅБ рІерѕџрЅђрІЮрЇЇ рѕ░рІЇрЇА рѕўрѕЃріерѕѕріЏ рЅђрѕІ рІФрѕѕ рІерЅєрІ│ рЅђрѕѕрѕЮ
­ЪџБ­ЪЈй	рїђрѕЇрЅБ рІерѕџрЅђрІЮрЇЇ рѕ░рІЇрЇА рѕўрѕЃріерѕѕріЏ рІерЅєрІ│ рЅђрѕѕрѕЮ
­ЪџБ­ЪЈЙ	рїђрѕЇрЅБ рІерѕџрЅђрІЮрЇЇ рѕ░рІЇрЇА рѕўрѕЃріерѕѕріЏ рЅђрѕІ рІФрѕѕ рІерЅєрІ│ рЅђрѕѕрѕЮ
­ЪџБ­ЪЈ┐	рїђрѕЇрЅБ рІерѕџрЅђрІЮрЇЇ рѕ░рІЇрЇА рїЦрЅЂрѕГ рІерЅєрІ│ рЅђрѕѕрѕЮ
­ЪџБРђЇРЎѓ№ИЈ	рѕ░рІЇ рІерѕџрЅђрІЮрЇЇ рїђрѕЇрЅБ
­ЪџБРђЇРЎѓ	рѕ░рІЇ рІерѕџрЅђрІЮрЇЇ рїђрѕЇрЅБ
­ЪџБ­ЪЈ╗РђЇРЎѓ№ИЈ	рѕ░рІЇ рІерѕџрЅђрІЮрЇЇ рїђрѕЇрЅБрЇА рЅђрѕІрѕЇ рІерЅєрІ│ рЅђрѕѕрѕЮ
­ЪџБ­ЪЈ╗РђЇРЎѓ	рѕ░рІЇ рІерѕџрЅђрІЮрЇЇ рїђрѕЇрЅБрЇА рЅђрѕІрѕЇ рІерЅєрІ│ рЅђрѕѕрѕЮ
­ЪџБ­ЪЈ╝РђЇРЎѓ№ИЈ	рѕ░рІЇ рІерѕџрЅђрІЮрЇЇ рїђрѕЇрЅБрЇА рѕўрѕЃріерѕѕріЏ рЅђрѕІ рІФрѕѕ рІерЅєрІ│ рЅђрѕѕрѕЮ
­ЪџБ­ЪЈ╝РђЇРЎѓ	рѕ░рІЇ рІерѕџрЅђрІЮрЇЇ рїђрѕЇрЅБрЇА рѕўрѕЃріерѕѕріЏ рЅђрѕІ рІФрѕѕ рІерЅєрІ│ рЅђрѕѕрѕЮ
­ЪџБ­ЪЈйРђЇРЎѓ№ИЈ	рѕ░рІЇ рІерѕџрЅђрІЮрЇЇ рїђрѕЇрЅБрЇА рѕўрѕЃріерѕѕріЏ рІерЅєрІ│ рЅђрѕѕрѕЮ
­ЪџБ­ЪЈйРђЇРЎѓ	рѕ░рІЇ рІерѕџрЅђрІЮрЇЇ рїђрѕЇрЅБрЇА рѕўрѕЃріерѕѕріЏ рІерЅєрІ│ рЅђрѕѕрѕЮ
­ЪџБ­ЪЈЙРђЇРЎѓ№ИЈ	рѕ░рІЇ рІерѕџрЅђрІЮрЇЇ рїђрѕЇрЅБрЇА рѕўрѕЃріерѕѕріЏ рЅђрѕІ рІФрѕѕ рІерЅєрІ│ рЅђрѕѕрѕЮ
­ЪџБ­ЪЈЙРђЇРЎѓ	рѕ░рІЇ рІерѕџрЅђрІЮрЇЇ рїђрѕЇрЅБрЇА рѕўрѕЃріерѕѕріЏ рЅђрѕІ рІФрѕѕ рІерЅєрІ│ рЅђрѕѕрѕЮ
­ЪџБ­ЪЈ┐РђЇРЎѓ№ИЈ	рѕ░рІЇ рІерѕџрЅђрІЮрЇЇ рїђрѕЇрЅБрЇА рїЦрЅЂрѕГ рІерЅєрІ│ рЅђрѕѕрѕЮ
­ЪџБ­ЪЈ┐РђЇРЎѓ	рѕ░рІЇ рІерѕџрЅђрІЮрЇЇ рїђрѕЇрЅБрЇА рїЦрЅЂрѕГ рІерЅєрІ│ рЅђрѕѕрѕЮ
­ЪџБРђЇРЎђ№ИЈ	рѕ┤рЅх рІерѕЮрЅхрЅђрІЮрЇЇ рїђрѕЇрЅБ
­ЪџБРђЇРЎђ	рѕ┤рЅх рІерѕЮрЅхрЅђрІЮрЇЇ рїђрѕЇрЅБ
­ЪџБ­ЪЈ╗РђЇРЎђ№ИЈ	рѕ┤рЅх рІерѕЮрЅхрЅђрІЮрЇЇ рїђрѕЇрЅБрЇА рЅђрѕІрѕЇ рІерЅєрІ│ рЅђрѕѕрѕЮ
­ЪџБ­ЪЈ╗РђЇРЎђ	рѕ┤рЅх рІерѕЮрЅхрЅђрІЮрЇЇ рїђрѕЇрЅБрЇА рЅђрѕІрѕЇ рІерЅєрІ│ рЅђрѕѕрѕЮ
­ЪџБ­ЪЈ╝РђЇРЎђ№ИЈ	рѕ┤рЅх рІерѕЮрЅхрЅђрІЮрЇЇ рїђрѕЇрЅБрЇА рѕўрѕЃріерѕѕріЏ рЅђрѕІ рІФрѕѕ рІерЅєрІ│ рЅђрѕѕрѕЮ
­ЪџБ­ЪЈ╝РђЇРЎђ	рѕ┤рЅх рІерѕЮрЅхрЅђрІЮрЇЇ рїђрѕЇрЅБрЇА рѕўрѕЃріерѕѕріЏ рЅђрѕІ рІФрѕѕ рІерЅєрІ│ рЅђрѕѕрѕЮ
­ЪџБ­ЪЈйРђЇРЎђ№ИЈ	рѕ┤рЅх рЅђрІўрЇІ рїђрѕЇрЅБрЇА рѕўрѕЃріерѕѕріЏ рІерЅєрІ│ рЅђрѕѕрѕЮ
­ЪџБ­ЪЈйРђЇРЎђ	рѕ┤рЅх рЅђрІўрЇІ рїђрѕЇрЅБрЇА рѕўрѕЃріерѕѕріЏ рІерЅєрІ│ рЅђрѕѕрѕЮ
­ЪџБ­ЪЈЙРђЇРЎђ№ИЈ	рѕ┤рЅх рІерѕЮрЅхрЅђрІЮрЇЇ рїђрѕЇрЅБрЇА рѕўрѕЃріерѕѕріЏ рЅђрѕІ рІФрѕѕ рІерЅєрІ│ рЅђрѕѕрѕЮ
­ЪџБ­ЪЈЙРђЇРЎђ	рѕ┤рЅх рІерѕЮрЅхрЅђрІЮрЇЇ рїђрѕЇрЅБрЇА рѕўрѕЃріерѕѕріЏ рЅђрѕІ рІФрѕѕ рІерЅєрІ│ рЅђрѕѕрѕЮ
­ЪџБ­ЪЈ┐РђЇРЎђ№ИЈ	рѕ┤рЅх рІерѕЮрЅхрЅђрІЮрЇЇ рїђрѕЇрЅБрЇА рїЦрЅЂрѕГ рІерЅєрІ│ рЅђрѕѕрѕЮ
­ЪџБ­ЪЈ┐РђЇРЎђ	рѕ┤рЅх рІерѕЮрЅхрЅђрІЮрЇЇ рїђрѕЇрЅБрЇА рїЦрЅЂрѕГ рІерЅєрІ│ рЅђрѕѕрѕЮ
­ЪЈі	рѕ░рІЇ рІерѕџрІІріЮ
­ЪЈі­ЪЈ╗	рІерѕџрІІріЮ рѕ░рІЇрЇА рЅђрѕІрѕЇ рІерЅєрІ│ рЅђрѕѕрѕЮ
­ЪЈі­ЪЈ╝	рІерѕџрІІріЮ рѕ░рІЇрЇА рѕўрѕЃріерѕѕріЏ рЅђрѕІ рІФрѕѕ рІерЅєрІ│ рЅђрѕѕрѕЮ
­ЪЈі­ЪЈй	рІерѕџрІІріЮ рѕ░рІЇ: рѕўрѕЃріерѕѕріЏ рІерЅєрІ│ рЅђрѕѕрѕЮ
­ЪЈі­ЪЈЙ	рІерѕџрІІріЮ рѕ░рІЇрЇА рѕўрѕЃріерѕѕріЏ рЅђрѕІ рІФрѕѕ рІерЅєрІ│ рЅђрѕѕрѕЮ
­ЪЈі­ЪЈ┐	рІерѕџрІІріЮ рѕ░рІЇ: рїЦрЅЂрѕГ рІерЅєрІ│ рЅђрѕѕрѕЮ
­ЪЈіРђЇРЎѓ№ИЈ	рѕ░рІЇ ріЦрІерІІріў
­ЪЈіРђЇРЎѓ	рѕ░рІЇ ріЦрІерІІріў
­ЪЈі­ЪЈ╗РђЇРЎѓ№ИЈ	рѕ░рІЇ рІІріЊ: рЅђрѕІрѕЇ рІерЅєрІ│ рЅђрѕѕрѕЮ
­ЪЈі­ЪЈ╗РђЇРЎѓ	рѕ░рІЇ рІІріЊ: рЅђрѕІрѕЇ рІерЅєрІ│ рЅђрѕѕрѕЮ
­ЪЈі­ЪЈ╝РђЇРЎѓ№ИЈ	рѕ░рІЇ рІІріЊ: рѕўрѕЃріерѕѕріЏ рЅђрѕІ рІФрѕѕ рІерЅєрІ│ рЅђрѕѕрѕЮ
­ЪЈі­ЪЈ╝РђЇРЎѓ	рѕ░рІЇ рІІріЊ: рѕўрѕЃріерѕѕріЏ-рЅђрѕІрѕЇ рІерЅєрІ│ рЅђрѕѕрѕЮ
­ЪЈі­ЪЈйРђЇРЎѓ№ИЈ	рѕ░рІЇ рѕўрІІріўрЅх: рѕўрѕЃріерѕѕріЏ рІерЅєрІ│ рЅђрѕѕрѕЮ
­ЪЈі­ЪЈйРђЇРЎѓ	рѕ░рІЇ рѕўрІІріўрЅх: рѕўрѕЃріерѕѕріЏ рІерЅєрІ│ рЅђрѕѕрѕЮ
­ЪЈі­ЪЈЙРђЇРЎѓ№ИЈ	рѕ░рІЇ рІІріЊ: рѕўрѕЃріерѕѕріЏ-рїЦрЅЂрѕГ рІерЅєрІ│ рЅђрѕѕрѕЮ
­ЪЈі­ЪЈЙРђЇРЎѓ	рѕ░рІЇ рІІріЊ: рѕўрѕЃріерѕѕріЏ-рїЦрЅЂрѕГ рІерЅєрІ│ рЅђрѕѕрѕЮ
­ЪЈі­ЪЈ┐РђЇРЎѓ№ИЈ	рѕ░рІЇ рІІріЊ: рїЦрЅЂрѕГ рІерЅєрІ│ рЅђрѕѕрѕЮ
­ЪЈі­ЪЈ┐РђЇРЎѓ	рѕ░рІЇ рІІріЊ: рїЦрЅЂрѕГ рІерЅєрІ│ рЅђрѕѕрѕЮ
­ЪЈіРђЇРЎђ№ИЈ	рѕ┤рЅх рѕхрЅхрІІріЮ
­ЪЈіРђЇРЎђ	рѕ┤рЅх рѕхрЅхрІІріЮ
­ЪЈі­ЪЈ╗РђЇРЎђ№ИЈ	рѕ┤рЅх рѕхрЅхрІІріЮрЇА рЅђрѕІрѕЇ рІерЅєрІ│ рЅђрѕѕрѕЮ
­ЪЈі­ЪЈ╗РђЇРЎђ	рѕ┤рЅх рѕхрЅхрІІріЮрЇА рЅђрѕІрѕЇ рІерЅєрІ│ рЅђрѕѕрѕЮ
­ЪЈі­ЪЈ╝РђЇРЎђ№ИЈ	рѕ┤рЅх рІІріЊрЇА рѕўрѕЃріерѕѕріЏ рЅђрѕІ рІФрѕѕ рІерЅєрІ│ рЅђрѕѕрѕЮ
­ЪЈі­ЪЈ╝РђЇРЎђ	рѕ┤рЅх рІІріЊрЇА рѕўрѕЃріерѕѕріЏ рЅђрѕІ рІФрѕѕ рІерЅєрІ│ рЅђрѕѕрѕЮ
­ЪЈі­ЪЈйРђЇРЎђ№ИЈ	рѕ┤рЅх рІІріЊ: рѕўрѕЃріерѕѕріЏ рІерЅєрІ│ рЅђрѕѕрѕЮ
­ЪЈі­ЪЈйРђЇРЎђ	рѕ┤рЅх рІІріЊ: рѕўрѕЃріерѕѕріЏ рІерЅєрІ│ рЅђрѕѕрѕЮ
­ЪЈі­ЪЈЙРђЇРЎђ№ИЈ	рѕ┤рЅх рІІріЊ: рѕўрѕЃріерѕѕріЏ-рїЦрЅЂрѕГ рІерЅєрІ│ рЅђрѕѕрѕЮ
­ЪЈі­ЪЈЙРђЇРЎђ	рѕ┤рЅх рІІріЊ: рѕўрѕЃріерѕѕріЏ-рїЦрЅЂрѕГ рІерЅєрІ│ рЅђрѕѕрѕЮ
­ЪЈі­ЪЈ┐РђЇРЎђ№ИЈ	рѕ┤рЅх рѕхрЅхрІІріЮ: рїЦрЅЂрѕГ рІерЅєрІ│ рЅђрѕѕрѕЮ
­ЪЈі­ЪЈ┐РђЇРЎђ	рѕ┤рЅх рѕхрЅхрІІріЮ: рїЦрЅЂрѕГ рІерЅєрІ│ рЅђрѕѕрѕЮ
РЏ╣№ИЈ	рі│рѕх рІерѕџрІѕрІЏрІѕрІЮ рѕ░рІЇ
РЏ╣	рі│рѕх рІерѕџрІѕрІЏрІѕрІЮ рѕ░рІЇ
РЏ╣­ЪЈ╗	рі│рѕх рІерѕџрІѕрІЏрІѕрІЮ рѕ░рІЇрЇА рЅђрѕІрѕЇ рІерЅєрІ│ рЅђрѕѕрѕЮ
РЏ╣­ЪЈ╝	рі│рѕх рІерѕџрІѕрІЏрІѕрІЮ рѕ░рІЇрЇА рѕўрѕЃріерѕѕріЏ рЅђрѕІ рІФрѕѕ рІерЅєрІ│ рЅђрѕѕрѕЮ
РЏ╣­ЪЈй	рі│рѕх рІерѕџрІѕрІЏрІѕрІЮ рѕ░рІЇрЇА рѕўрѕЃріерѕѕріЏ рІерЅєрІ│ рЅђрѕѕрѕЮ
РЏ╣­ЪЈЙ	рі│рѕх рІерѕџрІѕрІЏрІѕрІЮ рѕ░рІЇрЇА рѕўрѕЃріерѕѕріЏ рЅђрѕІ рІФрѕѕ рІерЅєрІ│ рЅђрѕѕрѕЮ
РЏ╣­ЪЈ┐	рі│рѕх рІерѕџрІѕрІЏрІѕрІЮ рѕ░рІЇрЇА рїЦрЅЂрѕГ рІерЅєрІ│ рЅђрѕѕрѕЮ
РЏ╣№ИЈРђЇРЎѓ№ИЈ	рі│рѕх рІерѕџрІѕрІЏрІѕрІЮ рѕ░рІЇ
РЏ╣РђЇРЎѓ№ИЈ	рі│рѕх рІерѕџрІѕрІЏрІѕрІЮ рѕ░рІЇ
РЏ╣№ИЈРђЇРЎѓ	рі│рѕх рІерѕџрІѕрІЏрІѕрІЮ рѕ░рІЇ
РЏ╣РђЇРЎѓ	рі│рѕх рІерѕџрІѕрІЏрІѕрІЮ рѕ░рІЇ
РЏ╣­ЪЈ╗РђЇРЎѓ№ИЈ	рі│рѕх рІерѕџрІѕрІЏрІѕрІЮ рѕ░рІЇрЇА рЅђрѕІрѕЇ рІерЅєрІ│ рЅђрѕѕрѕЮ
РЏ╣­ЪЈ╗РђЇРЎѓ	рі│рѕх рІерѕџрІѕрІЏрІѕрІЮ рѕ░рІЇрЇА рЅђрѕІрѕЇ рІерЅєрІ│ рЅђрѕѕрѕЮ
РЏ╣­ЪЈ╝РђЇРЎѓ№ИЈ	рі│рѕх рІерѕџрІѕрІЏрІѕрІЮ рѕ░рІЇрЇА рѕўрѕЃріерѕѕріЏ рЅђрѕІ рІФрѕѕ рІерЅєрІ│ рЅђрѕѕрѕЮ
РЏ╣­ЪЈ╝РђЇРЎѓ	рі│рѕх рІерѕџрІѕрІЏрІѕрІЮ рѕ░рІЇрЇА рѕўрѕЃріерѕѕріЏ рЅђрѕІ рІФрѕѕ рІерЅєрІ│ рЅђрѕѕрѕЮ
РЏ╣­ЪЈйРђЇРЎѓ№ИЈ	рі│рѕх рІерѕџрІѕрІЏрІѕрІЮ рѕ░рІЇрЇА рѕўрѕЃріерѕѕріЏ рІерЅєрІ│ рЅђрѕѕрѕЮ
РЏ╣­ЪЈйРђЇРЎѓ	рі│рѕх рІерѕџрІѕрІЏрІѕрІЮ рѕ░рІЇрЇА рѕўрѕЃріерѕѕріЏ рІерЅєрІ│ рЅђрѕѕрѕЮ
РЏ╣­ЪЈЙРђЇРЎѓ№ИЈ	рі│рѕх рІерѕџрІѕрІЏрІѕрІЮ рѕ░рІЇрЇА рѕўрѕЃріерѕѕріЏ рЅђрѕІ рІФрѕѕ рІерЅєрІ│ рЅђрѕѕрѕЮ
РЏ╣­ЪЈЙРђЇРЎѓ	рі│рѕх рІерѕџрІѕрІЏрІѕрІЮ рѕ░рІЇрЇА рѕўрѕЃріерѕѕріЏ рЅђрѕІ рІФрѕѕ рІерЅєрІ│ рЅђрѕѕрѕЮ
РЏ╣­ЪЈ┐РђЇРЎѓ№ИЈ	рі│рѕх рІерѕџрІѕрІЏрІѕрІЮ рѕ░рІЇрЇА рїЦрЅЂрѕГ рІерЅєрІ│ рЅђрѕѕрѕЮ
РЏ╣­ЪЈ┐РђЇРЎѓ	рі│рѕх рІерѕџрІѕрІЏрІѕрІЮ рѕ░рІЇрЇА рїЦрЅЂрѕГ рІерЅєрІ│ рЅђрѕѕрѕЮ
РЏ╣№ИЈРђЇРЎђ№ИЈ	рі│рѕх рІерѕЮрЅхрІѕрІЏрІѕрІЮ рѕ┤рЅх
РЏ╣РђЇРЎђ№ИЈ	рі│рѕх рІерѕЮрЅхрІѕрІЏрІѕрІЮ рѕ┤рЅх
РЏ╣№ИЈРђЇРЎђ	рі│рѕх рІерѕЮрЅхрІѕрІЏрІѕрІЮ рѕ┤рЅх
РЏ╣РђЇРЎђ	рі│рѕх рІерѕЮрЅхрІѕрІЏрІѕрІЮ рѕ┤рЅх
РЏ╣­ЪЈ╗РђЇРЎђ№ИЈ	рѕ┤рЅх рІерѕЮрЅхрІѕрІЏрІѕрІЮ рі│рѕхрЇА рЅђрѕІрѕЇ рІерЅєрІ│ рЅђрѕѕрѕЮ
РЏ╣­ЪЈ╗РђЇРЎђ	рѕ┤рЅх рІерѕЮрЅхрІѕрІЏрІѕрІЮ рі│рѕхрЇА рЅђрѕІрѕЇ рІерЅєрІ│ рЅђрѕѕрѕЮ
РЏ╣­ЪЈ╝РђЇРЎђ№ИЈ	рѕ┤рЅх рІерѕЮрЅхрІѕрІЏрІѕрІЮ рі│рѕхрЇА рѕўрѕЃріерѕѕріЏ рЅђрѕІ рІФрѕѕ рІерЅєрІ│ рЅђрѕѕрѕЮ
РЏ╣­ЪЈ╝РђЇРЎђ	рѕ┤рЅх рІерѕЮрЅхрІѕрІЏрІѕрІЮ рі│рѕхрЇА рѕўрѕЃріерѕѕріЏ рЅђрѕІ рІФрѕѕ рІерЅєрІ│ рЅђрѕѕрѕЮ
РЏ╣­ЪЈйРђЇРЎђ№ИЈ	рѕ┤рЅх рІерѕЮрЅхрІѕрІЏрІѕрІЮ рі│рѕхрЇА рѕўрѕЃріерѕѕріЏ рІерЅєрІ│ рЅђрѕѕрѕЮ
РЏ╣­ЪЈйРђЇРЎђ	рѕ┤рЅх рІерѕЮрЅхрІѕрІЏрІѕрІЮ рі│рѕхрЇА рѕўрѕЃріерѕѕріЏ рІерЅєрІ│ рЅђрѕѕрѕЮ
РЏ╣­ЪЈЙРђЇРЎђ№ИЈ	рі│рѕх рІерѕЮрЅхрІѕрїБ рѕ┤рЅхрЇА рѕўрѕЃріерѕѕріЏ рЅђрѕІ рІФрѕѕ рІерЅєрІ│ рЅђрѕѕрѕЮ
РЏ╣­ЪЈЙРђЇРЎђ	рі│рѕх рІерѕЮрЅхрІѕрїБ рѕ┤рЅхрЇА рѕўрѕЃріерѕѕріЏ рЅђрѕІ рІФрѕѕ рІерЅєрІ│ рЅђрѕѕрѕЮ
РЏ╣­ЪЈ┐РђЇРЎђ№ИЈ	рі│рѕх рІерѕЮрЅхрІѕрІЏрІѕрІЮ рѕ┤рЅхрЇА рїЦрЅЂрѕГ рІерЅєрІ│ рЅђрѕѕрѕЮ
РЏ╣­ЪЈ┐РђЇРЎђ	рі│рѕх рІерѕЮрЅхрІѕрІЏрІѕрІЮ рѕ┤рЅхрЇА рїЦрЅЂрѕГ рІерЅєрІ│ рЅђрѕѕрѕЮ
­ЪЈІ№ИЈ	рѕ░рІЇ ріГрЅЦрІ░рЅх рѕЏріЋрѕ│рЅх
­ЪЈІ	рѕ░рІЇ ріГрЅЦрІ░рЅх рѕЏріЋрѕ│рЅх
­ЪЈІ­ЪЈ╗	ріГрЅЦрІ░рЅхріЋ рІерѕџрІФріљрѕ│ рѕ░рІЇрЇА рЅђрѕІрѕЇ рІерЅєрІ│ рЅђрѕѕрѕЮ
­ЪЈІ­ЪЈ╝	ріГрЅЦрІ░рЅхріЋ рІерѕџрІФріљрѕ│ рѕ░рІЇрЇА рѕўрѕЃріерѕѕріЏ рЅђрѕІ рІФрѕѕ рІерЅєрІ│ рЅђрѕѕрѕЮ
­ЪЈІ­ЪЈй	ріГрЅЦрІ░рЅхріЋ рІерѕџрІФріљрѕ│ рѕ░рІЇ: рѕўрѕЃріерѕѕріЏ рІерЅєрІ│ рЅђрѕѕрѕЮ
­ЪЈІ­ЪЈЙ	ріГрЅЦрІ░рЅхріЋ рІерѕџрІФріљрѕ│ рѕ░рІЇрЇА рѕўрѕЃріерѕѕріЏ рЅђрѕІ рІФрѕѕ рІерЅєрІ│ рЅђрѕѕрѕЮ
­ЪЈІ­ЪЈ┐	ріГрЅЦрІ░рЅхріЋ рІерѕџрІФріљрѕ│ рѕ░рІЇ: рїЦрЅЂрѕГ рІерЅєрІ│ рЅђрѕѕрѕЮ
­ЪЈІ№ИЈРђЇРЎѓ№ИЈ	рѕ░рІЇ ріГрЅЦрІ░рЅх рѕЏріЋрѕ│рЅх
­ЪЈІРђЇРЎѓ№ИЈ	рѕ░рІЇ ріГрЅЦрІ░рЅх рѕЏріЋрѕ│рЅх
­ЪЈІ№ИЈРђЇРЎѓ	рѕ░рІЇ ріГрЅЦрІ░рЅх рѕЏріЋрѕ│рЅх
­ЪЈІРђЇРЎѓ	рѕ░рІЇ ріГрЅЦрІ░рЅх рѕЏріЋрѕ│рЅх
­ЪЈІ­ЪЈ╗РђЇРЎѓ№ИЈ	рѕ░рІЇ ріГрЅЦрІ░рЅх рѕЏріЋрѕ│рЅх: рЅђрѕІрѕЇ рІерЅєрІ│ рЅђрѕѕрѕЮ
­ЪЈІ­ЪЈ╗РђЇРЎѓ	рѕ░рІЇ ріГрЅЦрІ░рЅх рѕЏріЋрѕ│рЅх: рЅђрѕІрѕЇ рІерЅєрІ│ рЅђрѕѕрѕЮ
­ЪЈІ­ЪЈ╝РђЇРЎѓ№ИЈ	рѕ░рІЇ ріГрЅЦрІ░рЅх рѕЏріЋрѕ│рЅхрЇА рѕўрѕЃріерѕѕріЏ рЅђрѕІ рІФрѕѕ рІерЅєрІ│ рЅђрѕѕрѕЮ
­ЪЈІ­ЪЈ╝РђЇРЎѓ	рѕ░рІЇ ріГрЅЦрІ░рЅх рѕЏріЋрѕ│рЅхрЇА рѕўрѕЃріерѕѕріЏ рЅђрѕІ рІФрѕѕ рІерЅєрІ│ рЅђрѕѕрѕЮ
­ЪЈІ­ЪЈйРђЇРЎѓ№ИЈ	рѕ░рІЇ ріГрЅЦрІ░рЅх рѕЏріЋрѕ│рЅх: рѕўрѕЃріерѕѕріЏ рІерЅєрІ│ рЅђрѕѕрѕЮ
­ЪЈІ­ЪЈйРђЇРЎѓ	рѕ░рІЇ ріГрЅЦрІ░рЅх рѕЏріЋрѕ│рЅх: рѕўрѕЃріерѕѕріЏ рІерЅєрІ│ рЅђрѕѕрѕЮ
­ЪЈІ­ЪЈЙРђЇРЎѓ№ИЈ	рѕ░рІЇ ріГрЅЦрІ░рЅх рѕЏріЋрѕ│рЅхрЇА рѕўрѕЃріерѕѕріЏ рЅђрѕІ рІФрѕѕ рІерЅєрІ│ рЅђрѕѕрѕЮ
­ЪЈІ­ЪЈЙРђЇРЎѓ	рѕ░рІЇ ріГрЅЦрІ░рЅх рѕЏріЋрѕ│рЅхрЇА рѕўрѕЃріерѕѕріЏ рЅђрѕІ рІФрѕѕ рІерЅєрІ│ рЅђрѕѕрѕЮ
­ЪЈІ­ЪЈ┐РђЇРЎѓ№ИЈ	рѕ░рІЇ ріГрЅЦрІ░рЅх рѕЏріЋрѕ│рЅх: рїЦрЅЂрѕГ рІерЅєрІ│ рЅђрѕѕрѕЮ
­ЪЈІ­ЪЈ┐РђЇРЎѓ	рѕ░рІЇ ріГрЅЦрІ░рЅх рѕЏріЋрѕ│рЅх: рїЦрЅЂрѕГ рІерЅєрІ│ рЅђрѕѕрѕЮ
­ЪЈІ№ИЈРђЇРЎђ№ИЈ	рѕ┤рЅх ріГрЅЦрІ░рЅх рѕЏріЋрѕ│рЅх
­ЪЈІРђЇРЎђ№ИЈ	рѕ┤рЅх ріГрЅЦрІ░рЅх рѕЏріЋрѕ│рЅх
­ЪЈІ№ИЈРђЇРЎђ	рѕ┤рЅх ріГрЅЦрІ░рЅх рѕЏріЋрѕ│рЅх
­ЪЈІРђЇРЎђ	рѕ┤рЅх ріГрЅЦрІ░рЅх рѕЏріЋрѕ│рЅх
­ЪЈІ­ЪЈ╗РђЇРЎђ№ИЈ	ріГрЅЦрІ░рЅх рѕЏріЋрѕ│рЅх рѕ┤рЅх: рЅђрѕІрѕЇ рІерЅєрІ│ рЅђрѕѕрѕЮ
­ЪЈІ­ЪЈ╗РђЇРЎђ	ріГрЅЦрІ░рЅх рѕЏріЋрѕ│рЅх рѕ┤рЅх: рЅђрѕІрѕЇ рІерЅєрІ│ рЅђрѕѕрѕЮ
­ЪЈІ­ЪЈ╝РђЇРЎђ№ИЈ	ріГрЅЦрІ░рЅх рѕЏріЋрѕ│рЅх рѕ┤рЅхрЇА рѕўрѕЃріерѕѕріЏ рЅђрѕІ рІФрѕѕ рІерЅєрІ│ рЅђрѕѕрѕЮ
­ЪЈІ­ЪЈ╝РђЇРЎђ	ріГрЅЦрІ░рЅх рѕЏріЋрѕ│рЅх рѕ┤рЅхрЇА рѕўрѕЃріерѕѕріЏ рЅђрѕІ рІФрѕѕ рІерЅєрІ│ рЅђрѕѕрѕЮ
­ЪЈІ­ЪЈйРђЇРЎђ№ИЈ	ріГрЅЦрІ░рЅх рѕЏріЋрѕ│рЅх рѕ┤рЅх: рѕўрѕЃріерѕѕріЏ рІерЅєрІ│ рЅђрѕѕрѕЮ
­ЪЈІ­ЪЈйРђЇРЎђ	ріГрЅЦрІ░рЅх рѕЏріЋрѕ│рЅх рѕ┤рЅх: рѕўрѕЃріерѕѕріЏ рІерЅєрІ│ рЅђрѕѕрѕЮ
­ЪЈІ­ЪЈЙРђЇРЎђ№ИЈ	ріГрЅЦрІ░рЅх рѕЏріЋрѕ│рЅх рѕ┤рЅхрЇА рѕўрѕЃріерѕѕріЏ рЅђрѕІ рІФрѕѕ рІерЅєрІ│ рЅђрѕѕрѕЮ
­ЪЈІ­ЪЈЙРђЇРЎђ	ріГрЅЦрІ░рЅх рѕЏріЋрѕ│рЅх рѕ┤рЅхрЇА рѕўрѕЃріерѕѕріЏ рЅђрѕІ рІФрѕѕ рІерЅєрІ│ рЅђрѕѕрѕЮ
­ЪЈІ­ЪЈ┐РђЇРЎђ№ИЈ	ріГрЅЦрІ░рЅх рѕЏріЋрѕ│рЅх рѕ┤рЅх: рїЦрЅЂрѕГ рІерЅєрІ│ рЅђрѕѕрѕЮ
­ЪЈІ­ЪЈ┐РђЇРЎђ	ріГрЅЦрІ░рЅх рѕЏріЋрѕ│рЅх рѕ┤рЅх: рїЦрЅЂрѕГ рІерЅєрІ│ рЅђрѕѕрѕЮ
­Ъџ┤	рѕ░рІЇ рЅЦрѕхріГрѕїрЅх рѕўріЋрІ│рЅх
­Ъџ┤­ЪЈ╗	рѕ░рІЇ рЅбрѕхріГрѕїрЅх рѕўріЋрІ│рЅхрЇА рЅђрѕІрѕЇ рІерЅєрІ│ рЅђрѕѕрѕЮ
­Ъџ┤­ЪЈ╝	рѕ░рІЇ рЅбрѕхріГрѕїрЅх рѕўріЋрІ│рЅхрЇА рѕўрѕЃріерѕѕріЏ рЅђрѕІ рІФрѕѕ рІерЅєрІ│ рЅђрѕѕрѕЮ
­Ъџ┤­ЪЈй	рѕ░рІЇ рЅбрѕхріГрѕїрЅх рѕўріЋрІ│рЅхрЇА рѕўрѕЃріерѕѕріЏ рІерЅєрІ│ рЅђрѕѕрѕЮ
­Ъџ┤­ЪЈЙ	рѕ░рІЇ рЅбрѕхріГрѕїрЅх рѕўріЋрІ│рЅхрЇА рѕўрѕЃріерѕѕріЏ рЅђрѕІ рІФрѕѕ рІерЅєрІ│ рЅђрѕѕрѕЮ
­Ъџ┤­ЪЈ┐	рѕ░рІЇ рЅбрѕхріГрѕїрЅх рѕўріЋрІ│рЅхрЇА рїЦрЅЂрѕГ рІерЅєрІ│ рЅђрѕѕрѕЮ
­Ъџ┤РђЇРЎѓ№ИЈ	рІѕріЋрІх рЅЦрѕхріГрѕїрЅх рѕўріЋрІ│рЅх
­Ъџ┤РђЇРЎѓ	рІѕріЋрІх рЅЦрѕхріГрѕїрЅх рѕўріЋрІ│рЅх
­Ъџ┤­ЪЈ╗РђЇРЎѓ№ИЈ	рѕ░рІЇ рЅбрѕхріГрѕїрЅх рѕўріЋрІ│рЅх: рЅђрѕІрѕЇ рІерЅєрІ│ рЅђрѕѕрѕЮ
­Ъџ┤­ЪЈ╗РђЇРЎѓ	рІѕріЋрІх рЅбрѕхріГрѕїрЅх рѕўріЋрІ│рЅх: рЅђрѕІрѕЇ рІерЅєрІ│ рЅђрѕѕрѕЮ
­Ъџ┤­ЪЈ╝РђЇРЎѓ№ИЈ	рІѕріЋрІх рЅбрѕхріГрѕїрЅх рѕўріЋрІ│рЅхрЇА рѕўрѕЃріерѕѕріЏ рЅђрѕІ рІФрѕѕ рІерЅєрІ│ рЅђрѕѕрѕЮ
­Ъџ┤­ЪЈ╝РђЇРЎѓ	рІѕріЋрІх рЅбрѕхріГрѕїрЅх рѕўріЋрІ│рЅхрЇА рѕўрѕЃріерѕѕріЏ рЅђрѕІ рІФрѕѕ рІерЅєрІ│ рЅђрѕѕрѕЮ
­Ъџ┤­ЪЈйРђЇРЎѓ№ИЈ	рІѕріЋрІх рЅЦрѕхріГрѕїрЅх рѕўріЋрІ│рЅх: рѕўрѕЃріерѕѕріЏ рІерЅєрІ│ рЅђрѕѕрѕЮ
­Ъџ┤­ЪЈйРђЇРЎѓ	рІѕріЋрІх рЅЦрѕхріГрѕїрЅх рѕўріЋрІ│рЅх: рѕўрѕЃріерѕѕріЏ рІерЅєрІ│ рЅђрѕѕрѕЮ
­Ъџ┤­ЪЈЙРђЇРЎѓ№ИЈ	рІѕріЋрІх рЅбрѕхріГрѕїрЅх рѕўріЋрІ│рЅхрЇА рѕўрѕЃріерѕѕріЏ рЅђрѕІ рІФрѕѕ рІерЅєрІ│ рЅђрѕѕрѕЮ
­Ъџ┤­ЪЈЙРђЇРЎѓ	рІѕріЋрІх рЅбрѕхріГрѕїрЅх рѕўріЋрІ│рЅхрЇА рѕўрѕЃріерѕѕріЏ рЅђрѕІ рІФрѕѕ рІерЅєрІ│ рЅђрѕѕрѕЮ
­Ъџ┤­ЪЈ┐РђЇРЎѓ№ИЈ	рІѕріЋрІх рЅЦрѕхріГрѕїрЅх рѕўріЋрІ│рЅх: рїЦрЅЂрѕГ рІерЅєрІ│ рЅђрѕѕрѕЮ
­Ъџ┤­ЪЈ┐РђЇРЎѓ	рІѕріЋрІх рЅЦрѕхріГрѕїрЅх рѕўріЋрІ│рЅх: рїЦрЅЂрѕГ рІерЅєрІ│ рЅђрѕѕрѕЮ
­Ъџ┤РђЇРЎђ№ИЈ	рѕ┤рЅх рЅЦрѕхріГрѕїрЅх рѕўріЋрІ│рЅх
­Ъџ┤РђЇРЎђ	рѕ┤рЅх рЅЦрѕхріГрѕїрЅх рѕўріЋрІ│рЅх
­Ъџ┤­ЪЈ╗РђЇРЎђ№ИЈ	рѕ┤рЅх рЅЦрѕхріГрѕїрЅх рѕўріЋрІ│рЅх: рЅђрѕІрѕЇ рІерЅєрІ│ рЅђрѕѕрѕЮ
­Ъџ┤­ЪЈ╗РђЇРЎђ	рѕ┤рЅх рЅЦрѕхріГрѕїрЅх рѕўріЋрІ│рЅх: рЅђрѕІрѕЇ рІерЅєрІ│ рЅђрѕѕрѕЮ
­Ъџ┤­ЪЈ╝РђЇРЎђ№ИЈ	рѕ┤рЅх рЅЦрѕхріГрѕїрЅх рѕўріЋрІ│рЅхрЇА рѕўрѕЃріерѕѕріЏ рЅђрѕІ рІФрѕѕ рІерЅєрІ│ рЅђрѕѕрѕЮ
­Ъџ┤­ЪЈ╝РђЇРЎђ	рѕ┤рЅх рЅЦрѕхріГрѕїрЅх рѕўріЋрІ│рЅхрЇА рѕўрѕЃріерѕѕріЏ рЅђрѕІ рІФрѕѕ рІерЅєрІ│ рЅђрѕѕрѕЮ
­Ъџ┤­ЪЈйРђЇРЎђ№ИЈ	рѕ┤рЅх рЅЦрѕхріГрѕїрЅх рѕўріЋрІ│рЅх: рѕўрѕЃріерѕѕріЏ рІерЅєрІ│ рЅђрѕѕрѕЮ
­Ъџ┤­ЪЈйРђЇРЎђ	рѕ┤рЅх рЅЦрѕхріГрѕїрЅх рѕўріЋрІ│рЅх: рѕўрѕЃріерѕѕріЏ рІерЅєрІ│ рЅђрѕѕрѕЮ
­Ъџ┤­ЪЈЙРђЇРЎђ№ИЈ	рѕ┤рЅх рЅЦрѕхріГрѕїрЅх рѕўріЋрІ│рЅхрЇА рѕўрѕЃріерѕѕріЏ рЅђрѕІ рІФрѕѕ рІерЅєрІ│ рЅђрѕѕрѕЮ
­Ъџ┤­ЪЈЙРђЇРЎђ	рѕ┤рЅх рЅЦрѕхріГрѕїрЅх рѕўріЋрІ│рЅхрЇА рѕўрѕЃріерѕѕріЏ рЅђрѕІ рІФрѕѕ рІерЅєрІ│ рЅђрѕѕрѕЮ
­Ъџ┤­ЪЈ┐РђЇРЎђ№ИЈ	рѕ┤рЅх рЅЦрѕхріГрѕїрЅх рѕўріЋрІ│рЅх: рїЦрЅЂрѕГ рІерЅєрІ│ рЅђрѕѕрѕЮ
­Ъџ┤­ЪЈ┐РђЇРЎђ	рѕ┤рЅх рЅЦрѕхріГрѕїрЅх рѕўріЋрІ│рЅх: рїЦрЅЂрѕГ рІерЅєрІ│ рЅђрѕѕрѕЮ
­Ъџх	рѕ░рІЇ рЅ░рѕФрѕФ рЅбрѕхріГрѕїрЅх
­Ъџх­ЪЈ╗	рѕ░рІЇ рЅ░рѕФрѕФ рЅбрѕхріГрѕїрЅх рѕўріЋрІ│рЅхрЇА рЅђрѕІрѕЇ рІерЅєрІ│ рЅђрѕѕрѕЮ
­Ъџх­ЪЈ╝	рѕ░рІЇ рЅ░рѕФрѕФ рЅбрѕхріГрѕїрЅхрЇА рѕўрѕЃріерѕѕріЏ рЅђрѕІ рІФрѕѕ рІерЅєрІ│ рЅђрѕѕрѕЮ
­Ъџх­ЪЈй	рѕ░рІЇ рЅ░рѕФрѕФ рЅбрѕхріГрѕїрЅх рѕўріЋрІ│рЅхрЇА рѕўрѕЃріерѕѕріЏ рІерЅєрІ│ рЅђрѕѕрѕЮ
­Ъџх­ЪЈЙ	рѕ░рІЇ рЅ░рѕФрѕФ рЅбрѕхріГрѕїрЅхрЇА рѕўрѕЃріерѕѕріЏ рЅђрѕІ рІФрѕѕ рІерЅєрІ│ рЅђрѕѕрѕЮ
­Ъџх­ЪЈ┐	рѕ░рІЇ рЅ░рѕФрѕФ рЅбрѕхріГрѕїрЅх: рїЦрЅЂрѕГ рІерЅєрІ│ рЅђрѕѕрѕЮ
­ЪџхРђЇРЎѓ№ИЈ	рѕ░рІЇ рЅ░рѕФрѕФ рЅбрѕхріГрѕїрЅх
­ЪџхРђЇРЎѓ	рѕ░рІЇ рЅ░рѕФрѕФ рЅбрѕхріГрѕїрЅх
­Ъџх­ЪЈ╗РђЇРЎѓ№ИЈ	рѕ░рІЇ рЅ░рѕФрѕФ рЅбрѕхріГрѕїрЅх: рЅђрѕІрѕЇ рІерЅєрІ│ рЅђрѕѕрѕЮ
­Ъџх­ЪЈ╗РђЇРЎѓ	рѕ░рІЇ рЅ░рѕФрѕФ рЅбрѕхріГрѕїрЅх: рЅђрѕІрѕЇ рІерЅєрІ│ рЅђрѕѕрѕЮ
­Ъџх­ЪЈ╝РђЇРЎѓ№ИЈ	рѕ░рІЇ рЅ░рѕФрѕФ рЅбрѕхріГрѕїрЅх: рѕўрѕЃріерѕѕріЏ рЅђрѕІ рІФрѕѕ рІерЅєрІ│ рЅђрѕѕрѕЮ
­Ъџх­ЪЈ╝РђЇРЎѓ	рѕ░рІЇ рЅ░рѕФрѕФ рЅбрѕхріГрѕїрЅх: рѕўрѕЃріерѕѕріЏ рЅђрѕІ рІФрѕѕ рІерЅєрІ│ рЅђрѕѕрѕЮ
­Ъџх­ЪЈйРђЇРЎѓ№ИЈ	рѕ░рІЇ рЅ░рѕФрѕФ рЅбрѕхріГрѕїрЅх: рѕўрѕЃріерѕѕріЏ рІерЅєрІ│ рЅђрѕѕрѕЮ
­Ъџх­ЪЈйРђЇРЎѓ	рѕ░рІЇ рЅ░рѕФрѕФ рЅбрѕхріГрѕїрЅх: рѕўрѕЃріерѕѕріЏ рІерЅєрІ│ рЅђрѕѕрѕЮ
­Ъџх­ЪЈЙРђЇРЎѓ№ИЈ	рѕ░рІЇ рЅ░рѕФрѕФ рЅбрѕхріГрѕїрЅх: рѕўрѕЃріерѕѕріЏ-рїЦрЅЂрѕГ рІерЅєрІ│ рЅђрѕѕрѕЮ
­Ъџх­ЪЈЙРђЇРЎѓ	рѕ░рІЇ рЅ░рѕФрѕФ рЅбрѕхріГрѕїрЅх: рѕўрѕЃріерѕѕріЏ-рїЦрЅЂрѕГ рІерЅєрІ│ рЅђрѕѕрѕЮ
­Ъџх­ЪЈ┐РђЇРЎѓ№ИЈ	рѕ░рІЇ рЅ░рѕФрѕФ рЅбрѕхріГрѕїрЅх: рїЦрЅЂрѕГ рІерЅєрІ│ рЅђрѕѕрѕЮ
­Ъџх­ЪЈ┐РђЇРЎѓ	рѕ░рІЇ рЅ░рѕФрѕФ рЅбрѕхріГрѕїрЅх: рїЦрЅЂрѕГ рІерЅєрІ│ рЅђрѕѕрѕЮ
­ЪџхРђЇРЎђ№ИЈ	рѕ┤рЅх рЅ░рѕФрѕФ рЅЦрѕхріГрѕїрЅх
­ЪџхРђЇРЎђ	рѕ┤рЅх рЅ░рѕФрѕФ рЅЦрѕхріГрѕїрЅх
­Ъџх­ЪЈ╗РђЇРЎђ№ИЈ	рѕ┤рЅх рЅ░рѕФрѕФ рЅбрѕхріГрѕїрЅх: рЅђрѕІрѕЇ рІерЅєрІ│ рЅђрѕѕрѕЮ
­Ъџх­ЪЈ╗РђЇРЎђ	рѕ┤рЅх рЅ░рѕФрѕФ рЅбрѕхріГрѕїрЅх рѕўріЋрІ│рЅхрЇА рЅђрѕІрѕЇ рІерЅєрІ│ рЅђрѕѕрѕЮ
­Ъџх­ЪЈ╝РђЇРЎђ№ИЈ	рѕ┤рЅх рЅ░рѕФрѕФ рЅбрѕхріГрѕїрЅх рѕўріЋрІ│рЅхрЇА рѕўрѕЃріерѕѕріЏ рЅђрѕІ рІФрѕѕ рІерЅєрІ│ рЅђрѕѕрѕЮ
­Ъџх­ЪЈ╝РђЇРЎђ	рѕ┤рЅх рЅ░рѕФрѕФ рЅбрѕхріГрѕїрЅхрЇА рѕўрѕЃріерѕѕріЏ рЅђрѕІ рІФрѕѕ рІерЅєрІ│ рЅђрѕѕрѕЮ
­Ъџх­ЪЈйРђЇРЎђ№ИЈ	рѕ┤рЅх рЅ░рѕФрѕФ рЅбрѕхріГрѕїрЅх: рѕўрѕЃріерѕѕріЏ рІерЅєрІ│ рЅђрѕѕрѕЮ
­Ъџх­ЪЈйРђЇРЎђ	рѕ┤рЅх рЅ░рѕФрѕФ рЅбрѕхріГрѕїрЅх: рѕўрѕЃріерѕѕріЏ рІерЅєрІ│ рЅђрѕѕрѕЮ
­Ъџх­ЪЈЙРђЇРЎђ№ИЈ	рѕ┤рЅх рЅ░рѕФрѕФ рЅбрѕхріГрѕїрЅх рѕўріЋрІ│рЅхрЇА рѕўрѕЃріерѕѕріЏ рЅђрѕІ рІФрѕѕ рІерЅєрІ│ рЅђрѕѕрѕЮ
­Ъџх­ЪЈЙРђЇРЎђ	рѕ┤рЅх рЅ░рѕФрѕФ рЅбрѕхріГрѕїрЅх рѕўріЋрІ│рЅхрЇА рѕўрѕЃріерѕѕріЏ рЅђрѕІ рІФрѕѕ рІерЅєрІ│ рЅђрѕѕрѕЮ
­Ъџх­ЪЈ┐РђЇРЎђ№ИЈ	рѕ┤рЅх рЅ░рѕФрѕФ рЅЦрѕхріГрѕїрЅх: рїЦрЅЂрѕГ рІерЅєрІ│ рЅђрѕѕрѕЮ
­Ъџх­ЪЈ┐РђЇРЎђ	рѕ┤рЅх рЅ░рѕФрѕФ рЅЦрѕхріГрѕїрЅх: рїЦрЅЂрѕГ рІерЅєрІ│ рЅђрѕѕрѕЮ
­ЪЈј№ИЈ	рІеріЦрѕйрЅЁрІхрѕЮрІхрѕЮ рѕўріфріЊ
­ЪЈј	рІеріЦрѕйрЅЁрІхрѕЮрІхрѕЮ рѕўріфріЊ
­ЪЈЇ№ИЈ	рѕърЅ░рѕГрѕ│рІГріГрѕЇ
­ЪЈЇ	рѕърЅ░рѕГрѕ│рІГріГрѕЇ
­ЪцИ	рѕ░рІЇ cartwheeling
­ЪцИ­ЪЈ╗	рѕ░рІЇ cartwheeling: рЅђрѕІрѕЇ рІерЅєрІ│ рЅђрѕѕрѕЮ
­ЪцИ­ЪЈ╝	рѕ░рІЇ cartwheeling: рѕўрѕЃріерѕѕріЏ рЅђрѕІ рІФрѕѕ рІерЅєрІ│ рЅђрѕѕрѕЮ
­ЪцИ­ЪЈй	рѕ░рІЇ cartwheeling: рѕўрѕЃріерѕѕріЏ рІерЅєрІ│ рЅђрѕѕрѕЮ
­ЪцИ­ЪЈЙ	рѕ░рІЇ cartwheeling: рѕўрѕЃріерѕѕріЏ рЅђрѕІ рІФрѕѕ рІерЅєрІ│ рЅђрѕѕрѕЮ
­ЪцИ­ЪЈ┐	рѕ░рІЇ cartwheeling: рїЦрЅЂрѕГ рІерЅєрІ│ рЅђрѕѕрѕЮ
­ЪцИРђЇРЎѓ№ИЈ	рѕ░рІЇ cartwheeling
­ЪцИРђЇРЎѓ	рѕ░рІЇ cartwheeling
­ЪцИ­ЪЈ╗РђЇРЎѓ№ИЈ	рѕ░рІЇ cartwheeling: рЅђрѕІрѕЇ рІерЅєрІ│ рЅђрѕѕрѕЮ
­ЪцИ­ЪЈ╗РђЇРЎѓ	рѕ░рІЇ cartwheeling: рЅђрѕІрѕЇ рІерЅєрІ│ рЅђрѕѕрѕЮ
­ЪцИ­ЪЈ╝РђЇРЎѓ№ИЈ	рѕ░рІЇ ріФрѕГрЅхрІірѕіріЋрїЇ: рѕўрѕЃріерѕѕріЏ рЅђрѕІ рІФрѕѕ рІерЅєрІ│ рЅђрѕѕрѕЮ
­ЪцИ­ЪЈ╝РђЇРЎѓ	рѕ░рІЇ ріФрѕГрЅхрІірѕіріЋрїЇ: рѕўрѕЃріерѕѕріЏ рЅђрѕІ рІФрѕѕ рІерЅєрІ│ рЅђрѕѕрѕЮ
­ЪцИ­ЪЈйРђЇРЎѓ№ИЈ	рѕ░рІЇ cartwheeling: рѕўрѕЃріерѕѕріЏ рІерЅєрІ│ рЅђрѕѕрѕЮ
­ЪцИ­ЪЈйРђЇРЎѓ	рѕ░рІЇ cartwheeling: рѕўрѕЃріерѕѕріЏ рІерЅєрІ│ рЅђрѕѕрѕЮ
­ЪцИ­ЪЈЙРђЇРЎѓ№ИЈ	рѕ░рІЇ ріФрѕГрЅхрІірѕіріЋрїЇ: рѕўрѕЃріерѕѕріЏ рЅђрѕІ рІФрѕѕ рІерЅєрІ│ рЅђрѕѕрѕЮ
­ЪцИ­ЪЈЙРђЇРЎѓ	рѕ░рІЇ ріФрѕГрЅхрІірѕіріЋрїЇ: рѕўрѕЃріерѕѕріЏ рЅђрѕІ рІФрѕѕ рІерЅєрІ│ рЅђрѕѕрѕЮ
­ЪцИ­ЪЈ┐РђЇРЎѓ№ИЈ	рѕ░рІЇ cartwheeling: рїЦрЅЂрѕГ рІерЅєрІ│ рЅђрѕѕрѕЮ
­ЪцИ­ЪЈ┐РђЇРЎѓ	рѕ░рІЇ cartwheeling: рїЦрЅЂрѕГ рІерЅєрІ│ рЅђрѕѕрѕЮ
­ЪцИРђЇРЎђ№ИЈ	рѕ┤рЅх cartwheeling
­ЪцИРђЇРЎђ	рѕ┤рЅх cartwheeling
­ЪцИ­ЪЈ╗РђЇРЎђ№ИЈ	рѕ┤рЅх cartwheeling: рЅђрѕІрѕЇ рІерЅєрІ│ рЅђрѕѕрѕЮ
­ЪцИ­ЪЈ╗РђЇРЎђ	рѕ┤рЅх cartwheeling: рЅђрѕІрѕЇ рІерЅєрІ│ рЅђрѕѕрѕЮ
­ЪцИ­ЪЈ╝РђЇРЎђ№ИЈ	рѕ┤рЅх cartwheeling: рѕўрѕЃріерѕѕріЏ рЅђрѕІ рІФрѕѕ рІерЅєрІ│ рЅђрѕѕрѕЮ
­ЪцИ­ЪЈ╝РђЇРЎђ	рѕ┤рЅх cartwheeling: рѕўрѕЃріерѕѕріЏ рЅђрѕІ рІФрѕѕ рІерЅєрІ│ рЅђрѕѕрѕЮ
­ЪцИ­ЪЈйРђЇРЎђ№ИЈ	рѕ┤рЅх cartwheeling: рѕўрѕЃріерѕѕріЏ рІерЅєрІ│ рЅђрѕѕрѕЮ
­ЪцИ­ЪЈйРђЇРЎђ	рѕ┤рЅх cartwheeling: рѕўрѕЃріерѕѕріЏ рІерЅєрІ│ рЅђрѕѕрѕЮ
­ЪцИ­ЪЈЙРђЇРЎђ№ИЈ	рѕ┤рЅх cartwheeling: рѕўрѕЃріерѕѕріЏ рЅђрѕІ рІФрѕѕ рІерЅєрІ│ рЅђрѕѕрѕЮ
­ЪцИ­ЪЈЙРђЇРЎђ	рѕ┤рЅх cartwheeling: рѕўрѕЃріерѕѕріЏ рЅђрѕІ рІФрѕѕ рІерЅєрІ│ рЅђрѕѕрѕЮ
­ЪцИ­ЪЈ┐РђЇРЎђ№ИЈ	рѕ┤рЅх cartwheeling: рїЦрЅЂрѕГ рІерЅєрІ│ рЅђрѕѕрѕЮ
­ЪцИ­ЪЈ┐РђЇРЎђ	рѕ┤рЅх cartwheeling: рїЦрЅЂрѕГ рІерЅєрІ│ рЅђрѕѕрѕЮ
­Ъц╝	рѕ░рІјрЅй рЅхрїЇрѕЇ
­Ъц╝РђЇРЎѓ№ИЈ	рІѕріЋрІХрЅй рЅхрїЇрѕЇ
­Ъц╝РђЇРЎѓ	рІѕріЋрІХрЅй рЅхрїЇрѕЇ
­Ъц╝РђЇРЎђ№ИЈ	рІерѕ┤рЅХрЅй рЅхрїЇрѕЇ
­Ъц╝РђЇРЎђ	рІерѕ┤рЅХрЅй рЅхрїЇрѕЇ
­Ъцй	рІерІЇрѕЃ рЇќрѕј рІерѕџрїФрІѕрЅх рѕ░рІЇ
­Ъцй­ЪЈ╗	рІерІЇрѕЃ рЇќрѕј рІерѕџрїФрІѕрЅх рѕ░рІЇрЇА рЅђрѕІрѕЇ рІерЅєрІ│ рЅђрѕѕрѕЮ
­Ъцй­ЪЈ╝	рІерІЇрѕЃ рЇќрѕј рІерѕџрїФрІѕрЅх рѕ░рІЇрЇА рѕўрѕЃріерѕѕріЏ рЅђрѕІ рІФрѕѕ рІерЅєрІ│ рЅђрѕѕрѕЮ
­Ъцй­ЪЈй	рІерІЇрѕЃ рЇќрѕј рІерѕџрїФрІѕрЅх рѕ░рІЇрЇА рѕўрѕЃріерѕѕріЏ рІерЅєрІ│ рЅђрѕѕрѕЮ
­Ъцй­ЪЈЙ	рІерІЇрѕЃ рЇќрѕј рІерѕџрїФрІѕрЅх рѕ░рІЇрЇА рѕўрѕЃріерѕѕріЏ рЅђрѕІ рІФрѕѕ рІерЅєрІ│ рЅђрѕѕрѕЮ
­Ъцй­ЪЈ┐	рІерІЇрѕЃ рЇќрѕј рІерѕџрїФрІѕрЅх рѕ░рІЇрЇА рїЦрЅЂрѕГ рІерЅєрІ│ рЅђрѕѕрѕЮ
­ЪцйРђЇРЎѓ№ИЈ	рІерІЇрѕЃ рЇќрѕј рІерѕџрїФрІѕрЅх рѕ░рІЇ
­ЪцйРђЇРЎѓ	рІерІЇрѕЃ рЇќрѕј рІерѕџрїФрІѕрЅх рѕ░рІЇ
­Ъцй­ЪЈ╗РђЇРЎѓ№ИЈ	рІерІЇрѕЃ рЇќрѕј рІерѕџрїФрІѕрЅх рѕ░рІЇрЇА рЅђрѕІрѕЇ рІерЅєрІ│ рЅђрѕѕрѕЮ
­Ъцй­ЪЈ╗РђЇРЎѓ	рІерІЇрѕЃ рЇќрѕј рІерѕџрїФрІѕрЅх рѕ░рІЇрЇА рЅђрѕІрѕЇ рІерЅєрІ│ рЅђрѕѕрѕЮ
­Ъцй­ЪЈ╝РђЇРЎѓ№ИЈ	рІерІЇрѕЃ рЇќрѕј рІерѕџрїФрІѕрЅх рѕ░рІЇрЇА рѕўрѕЃріерѕѕріЏ рЅђрѕІ рІФрѕѕ рІерЅєрІ│ рЅђрѕѕрѕЮ
­Ъцй­ЪЈ╝РђЇРЎѓ	рІерІЇрѕЃ рЇќрѕј рІерѕџрїФрІѕрЅх рѕ░рІЇрЇА рѕўрѕЃріерѕѕріЏ рЅђрѕІ рІФрѕѕ рІерЅєрІ│ рЅђрѕѕрѕЮ
­Ъцй­ЪЈйРђЇРЎѓ№ИЈ	рІерІЇрѕЃ рЇќрѕј рІерѕџрїФрІѕрЅх рѕ░рІЇ: рѕўрѕЃріерѕѕріЏ рІерЅєрІ│ рЅђрѕѕрѕЮ
­Ъцй­ЪЈйРђЇРЎѓ	рІерІЇрѕЃ рЇќрѕј рІерѕџрїФрІѕрЅх рѕ░рІЇ: рѕўрѕЃріерѕѕріЏ рІерЅєрІ│ рЅђрѕѕрѕЮ
­Ъцй­ЪЈЙРђЇРЎѓ№ИЈ	рІерІЇрѕЃ рЇќрѕј рІерѕџрїФрІѕрЅх рѕ░рІЇрЇА рѕўрѕЃріерѕѕріЏ рЅђрѕІ рІФрѕѕ рІерЅєрІ│ рЅђрѕѕрѕЮ
­Ъцй­ЪЈЙРђЇРЎѓ	рІерІЇрѕЃ рЇќрѕј рІерѕџрїФрІѕрЅх рѕ░рІЇрЇА рѕўрѕЃріерѕѕріЏ рЅђрѕІ рІФрѕѕ рІерЅєрІ│ рЅђрѕѕрѕЮ
­Ъцй­ЪЈ┐РђЇРЎѓ№ИЈ	рІерІЇрѕЃ рЇќрѕј рІерѕџрїФрІѕрЅх рѕ░рІЇ: рїЦрЅЂрѕГ рІерЅєрІ│ рЅђрѕѕрѕЮ
­Ъцй­ЪЈ┐РђЇРЎѓ	рІерІЇрѕЃ рЇќрѕј рІерѕџрїФрІѕрЅх рѕ░рІЇ: рїЦрЅЂрѕГ рІерЅєрІ│ рЅђрѕѕрѕЮ
­ЪцйРђЇРЎђ№ИЈ	рІерІЇрѕЃ рЇќрѕј рІерѕЮрЅхрїФрІѕрЅх рѕ┤рЅх
­ЪцйРђЇРЎђ	рІерІЇрѕЃ рЇќрѕј рІерѕЮрЅхрїФрІѕрЅх рѕ┤рЅх
­Ъцй­ЪЈ╗РђЇРЎђ№ИЈ	рІерІЇрѕЃ рЇќрѕј рІерѕЮрЅхрїФрІѕрЅх рѕ┤рЅхрЇА рЅђрѕІрѕЇ рІерЅєрІ│ рЅђрѕѕрѕЮ
­Ъцй­ЪЈ╗РђЇРЎђ	рІерІЇрѕЃ рЇќрѕј рІерѕЮрЅхрїФрІѕрЅх рѕ┤рЅхрЇА рЅђрѕІрѕЇ рІерЅєрІ│ рЅђрѕѕрѕЮ
­Ъцй­ЪЈ╝РђЇРЎђ№ИЈ	рІерІЇрѕЃ рЇќрѕј рІерѕЮрЅхрїФрІѕрЅх рѕ┤рЅхрЇА рѕўрѕЃріерѕѕріЏ рЅђрѕІ рІФрѕѕ рІерЅєрІ│ рЅђрѕѕрѕЮ
­Ъцй­ЪЈ╝РђЇРЎђ	рІерІЇрѕЃ рЇќрѕј рІерѕЮрЅхрїФрІѕрЅх рѕ┤рЅхрЇА рѕўрѕЃріерѕѕріЏ рЅђрѕІ рІФрѕѕ рІерЅєрІ│ рЅђрѕѕрѕЮ
­Ъцй­ЪЈйРђЇРЎђ№ИЈ	рІерІЇрѕЃ рЇќрѕј рІерѕЮрЅхрїФрІѕрЅх рѕ┤рЅх: рѕўрѕЃріерѕѕріЏ рІерЅєрІ│ рЅђрѕѕрѕЮ
­Ъцй­ЪЈйРђЇРЎђ	рІерІЇрѕЃ рЇќрѕј рІерѕЮрЅхрїФрІѕрЅх рѕ┤рЅх: рѕўрѕЃріерѕѕріЏ рІерЅєрІ│ рЅђрѕѕрѕЮ
­Ъцй­ЪЈЙРђЇРЎђ№ИЈ	рІерІЇрѕЃ рЇќрѕј рІерѕЮрЅхрїФрІѕрЅх рѕ┤рЅхрЇА рѕўрѕЃріерѕѕріЏ рЅђрѕІ рІФрѕѕ рІерЅєрІ│ рЅђрѕѕрѕЮ
­Ъцй­ЪЈЙРђЇРЎђ	рІерІЇрѕЃ рЇќрѕј рІерѕЮрЅхрїФрІѕрЅх рѕ┤рЅхрЇА рѕўрѕЃріерѕѕріЏ рЅђрѕІ рІФрѕѕ рІерЅєрІ│ рЅђрѕѕрѕЮ
­Ъцй­ЪЈ┐РђЇРЎђ№ИЈ	рІерІЇрѕЃ рЇќрѕј рІерѕЮрЅхрїФрІѕрЅх рѕ┤рЅх: рїЦрЅЂрѕГ рІерЅєрІ│ рЅђрѕѕрѕЮ
­Ъцй­ЪЈ┐РђЇРЎђ	рІерІЇрѕЃ рЇќрѕј рІерѕЮрЅхрїФрІѕрЅх рѕ┤рЅх: рїЦрЅЂрѕГ рІерЅєрІ│ рЅђрѕѕрѕЮ
­ЪцЙ	рІеріЦрїЁ рі│рѕх рІерѕџрїФрІѕрЅх рѕ░рІЇ
­ЪцЙ­ЪЈ╗	рІеріЦрїЁ рі│рѕх рІерѕџрїФрІѕрЅх рѕ░рІЇрЇА рЅђрѕІрѕЇ рІерЅєрІ│ рЅђрѕѕрѕЮ
­ЪцЙ­ЪЈ╝	рІеріЦрїЁ рі│рѕх рІерѕџрїФрІѕрЅх рѕ░рІЇрЇА рѕўрѕЃріерѕѕріЏ рЅђрѕІ рІФрѕѕ рІерЅєрІ│ рЅђрѕѕрѕЮ
­ЪцЙ­ЪЈй	рІеріЦрїЁ рі│рѕх рІерѕџрїФрІѕрЅх рѕ░рІЇрЇА рѕўрѕЃріерѕѕріЏ рІерЅєрІ│ рЅђрѕѕрѕЮ
­ЪцЙ­ЪЈЙ	рІеріЦрїЁ рі│рѕх рІерѕџрїФрІѕрЅх рѕ░рІЇрЇА рѕўрѕЃріерѕѕріЏ рЅђрѕІ рІФрѕѕ рІерЅєрІ│ рЅђрѕѕрѕЮ
­ЪцЙ­ЪЈ┐	рІеріЦрїЁ рі│рѕх рІерѕџрїФрІѕрЅх рѕ░рІЇ: рїЦрЅЂрѕГ рІерЅєрІ│ рЅђрѕѕрѕЮ
­ЪцЙРђЇРЎѓ№ИЈ	рѕ░рІЇ рІеріЦрїЁ рі│рѕх рѕўрїФрІѕрЅх
­ЪцЙРђЇРЎѓ	рѕ░рІЇ рІеріЦрїЁ рі│рѕх рѕўрїФрІѕрЅх
­ЪцЙ­ЪЈ╗РђЇРЎѓ№ИЈ	рІеріЦрїЁ рі│рѕх рІерѕџрїФрІѕрЅх рѕ░рІЇрЇА рЅђрѕІрѕЇ рІерЅєрІ│ рЅђрѕѕрѕЮ
­ЪцЙ­ЪЈ╗РђЇРЎѓ	рІеріЦрїЁ рі│рѕх рІерѕџрїФрІѕрЅх рѕ░рІЇрЇА рЅђрѕІрѕЇ рІерЅєрІ│ рЅђрѕѕрѕЮ
­ЪцЙ­ЪЈ╝РђЇРЎѓ№ИЈ	рІеріЦрїЁ рі│рѕх рІерѕџрїФрІѕрЅх рѕ░рІЇрЇА рѕўрѕЃріерѕѕріЏ рЅђрѕІ рІФрѕѕ рІерЅєрІ│ рЅђрѕѕрѕЮ
­ЪцЙ­ЪЈ╝РђЇРЎѓ	рІеріЦрїЁ рі│рѕх рІерѕџрїФрІѕрЅх рѕ░рІЇрЇА рѕўрѕЃріерѕѕріЏ рЅђрѕІ рІФрѕѕ рІерЅєрІ│ рЅђрѕѕрѕЮ
­ЪцЙ­ЪЈйРђЇРЎѓ№ИЈ	рІеріЦрїЁ рі│рѕх рІерѕџрїФрІѕрЅх рѕ░рІЇрЇА рѕўрѕЃріерѕѕріЏ рІерЅєрІ│ рЅђрѕѕрѕЮ
­ЪцЙ­ЪЈйРђЇРЎѓ	рІеріЦрїЁ рі│рѕх рІерѕџрїФрІѕрЅх рѕ░рІЇрЇА рѕўрѕЃріерѕѕріЏ рІерЅєрІ│ рЅђрѕѕрѕЮ
­ЪцЙ­ЪЈЙРђЇРЎѓ№ИЈ	рІеріЦрїЁ рі│рѕх рІерѕџрїФрІѕрЅх рѕ░рІЇрЇА рѕўрѕЃріерѕѕріЏ рЅђрѕІ рІФрѕѕ рІерЅєрІ│ рЅђрѕѕрѕЮ
­ЪцЙ­ЪЈЙРђЇРЎѓ	рІеріЦрїЁ рі│рѕх рІерѕџрїФрІѕрЅх рѕ░рІЇрЇА рѕўрѕЃріерѕѕріЏ рЅђрѕІ рІФрѕѕ рІерЅєрІ│ рЅђрѕѕрѕЮ
­ЪцЙ­ЪЈ┐РђЇРЎѓ№ИЈ	рІеріЦрїЁ рі│рѕх рІерѕџрїФрІѕрЅх рѕ░рІЇ: рїЦрЅЂрѕГ рІерЅєрІ│ рЅђрѕѕрѕЮ
­ЪцЙ­ЪЈ┐РђЇРЎѓ	рІеріЦрїЁ рі│рѕх рІерѕџрїФрІѕрЅх рѕ░рІЇ: рїЦрЅЂрѕГ рІерЅєрІ│ рЅђрѕѕрѕЮ
­ЪцЙРђЇРЎђ№ИЈ	рѕ┤рЅх рІеріЦрїЁ рі│рѕх рѕхрЅхрїФрІѕрЅх
­ЪцЙРђЇРЎђ	рѕ┤рЅх рІеріЦрїЁ рі│рѕх рѕхрЅхрїФрІѕрЅх
­ЪцЙ­ЪЈ╗РђЇРЎђ№ИЈ	рѕ┤рЅх рІеріЦрїЁ рі│рѕх рѕхрЅхрїФрІѕрЅхрЇА рЅђрѕІрѕЇ рІерЅєрІ│ рЅђрѕѕрѕЮ
­ЪцЙ­ЪЈ╗РђЇРЎђ	рѕ┤рЅх рІеріЦрїЁ рі│рѕх рѕхрЅхрїФрІѕрЅхрЇА рЅђрѕІрѕЇ рІерЅєрІ│ рЅђрѕѕрѕЮ
­ЪцЙ­ЪЈ╝РђЇРЎђ№ИЈ	рѕ┤рЅх рІеріЦрїЁ рі│рѕх рѕхрЅхрїФрІѕрЅхрЇА рѕўрѕЃріерѕѕріЏ рЅђрѕІ рІФрѕѕ рІерЅєрІ│ рЅђрѕѕрѕЮ
­ЪцЙ­ЪЈ╝РђЇРЎђ	рѕ┤рЅх рІеріЦрїЁ рі│рѕх рѕхрЅхрїФрІѕрЅхрЇА рѕўрѕЃріерѕѕріЏ рЅђрѕІ рІФрѕѕ рІерЅєрІ│ рЅђрѕѕрѕЮ
­ЪцЙ­ЪЈйРђЇРЎђ№ИЈ	рІеріЦрїЁ рі│рѕх рІерѕЮрЅхрїФрІѕрЅх рѕ┤рЅх: рѕўрѕЃріерѕѕріЏ рІерЅєрІ│ рЅђрѕѕрѕЮ
­ЪцЙ­ЪЈйРђЇРЎђ	рІеріЦрїЁ рі│рѕх рІерѕЮрЅхрїФрІѕрЅх рѕ┤рЅх: рѕўрѕЃріерѕѕріЏ рІерЅєрІ│ рЅђрѕѕрѕЮ
­ЪцЙ­ЪЈЙРђЇРЎђ№ИЈ	рѕ┤рЅх рІеріЦрїЁ рі│рѕх рѕхрЅхрїФрІѕрЅхрЇА рѕўрѕЃріерѕѕріЏ рЅђрѕІ рІФрѕѕ рІерЅєрІ│ рЅђрѕѕрѕЮ
­ЪцЙ­ЪЈЙРђЇРЎђ	рѕ┤рЅх рІеріЦрїЁ рі│рѕх рѕхрЅхрїФрІѕрЅхрЇА рѕўрѕЃріерѕѕріЏ рЅђрѕІ рІФрѕѕ рІерЅєрІ│ рЅђрѕѕрѕЮ
­ЪцЙ­ЪЈ┐РђЇРЎђ№ИЈ	рѕ┤рЅх рІеріЦрїЁ рі│рѕх рѕхрЅхрїФрІѕрЅх: рїЦрЅЂрѕГ рІерЅєрІ│ рЅђрѕѕрѕЮ
­ЪцЙ­ЪЈ┐РђЇРЎђ	рѕ┤рЅх рІеріЦрїЁ рі│рѕх рѕхрЅхрїФрІѕрЅх: рїЦрЅЂрѕГ рІерЅєрІ│ рЅђрѕѕрѕЮ
­Ъц╣	рѕ░рІЇ ріЦрІерѕ«рїа
­Ъц╣­ЪЈ╗	рѕ░рІЇ ріЦрІерѕ«рїарЇА рЅђрѕІрѕЇ рІерЅєрІ│ рЅђрѕѕрѕЮ
­Ъц╣­ЪЈ╝	рїђрїЇріЋрїЇ рѕ░рІЇрЇА рѕўрѕЃріерѕѕріЏ рЅђрѕІ рІФрѕѕ рІерЅєрІ│ рЅђрѕѕрѕЮ
­Ъц╣­ЪЈй	рѕ░рІЇ ріЦрІерѕ«рїарЇА рѕўрѕЃріерѕѕріЏ рІерЅєрІ│ рЅђрѕѕрѕЮ
­Ъц╣­ЪЈЙ	рїђрїЇріЋрїЇ рѕ░рІЇрЇА рѕўрѕЃріерѕѕріЏ рЅђрѕІ рІФрѕѕ рІерЅєрІ│ рЅђрѕѕрѕЮ
­Ъц╣­ЪЈ┐	ріЦрІерѕ«рїа рІФрѕѕ рѕ░рІЇрЇА рїЦрЅЂрѕГ рІерЅєрІ│ рЅђрѕѕрѕЮ
­Ъц╣РђЇРЎѓ№ИЈ	рѕ░рІЇ рїђрїЇріЋрїЇ
­Ъц╣РђЇРЎѓ	рѕ░рІЇ рїђрїЇріЋрїЇ
­Ъц╣­ЪЈ╗РђЇРЎѓ№ИЈ	рѕ░рІЇ рїђрїЇрѕіріЋрїЇрЇА рЅђрѕІрѕЇ рІерЅєрІ│ рЅђрѕѕрѕЮ
­Ъц╣­ЪЈ╗РђЇРЎѓ	рѕ░рІЇ рїђрїЇрѕіріЋрїЇрЇА рЅђрѕІрѕЇ рІерЅєрІ│ рЅђрѕѕрѕЮ
­Ъц╣­ЪЈ╝РђЇРЎѓ№ИЈ	рѕ░рІЇ рїђрїЇрѕіріЋрїЇрЇА рѕўрѕЃріерѕѕріЏ рЅђрѕІ рІФрѕѕ рІерЅєрІ│ рЅђрѕѕрѕЮ
­Ъц╣­ЪЈ╝РђЇРЎѓ	рѕ░рІЇ рїђрїЇрѕіріЋрїЇрЇА рѕўрѕЃріерѕѕріЏ рЅђрѕІ рІФрѕѕ рІерЅєрІ│ рЅђрѕѕрѕЮ
­Ъц╣­ЪЈйРђЇРЎѓ№ИЈ	рѕ░рІЇ рїђрїЇрѕіріЋрїЇ: рѕўрѕЃріерѕѕріЏ рІерЅєрІ│ рЅђрѕѕрѕЮ
­Ъц╣­ЪЈйРђЇРЎѓ	рѕ░рІЇ рїђрїЇрѕіріЋрїЇ: рѕўрѕЃріерѕѕріЏ рІерЅєрІ│ рЅђрѕѕрѕЮ
­Ъц╣­ЪЈЙРђЇРЎѓ№ИЈ	рѕ░рІЇ рїђрїЇрѕіріЋрїЇрЇА рѕўрѕЃріерѕѕріЏ рЅђрѕІ рІФрѕѕ рІерЅєрІ│ рЅђрѕѕрѕЮ
­Ъц╣­ЪЈЙРђЇРЎѓ	рѕ░рІЇ рїђрїЇрѕіріЋрїЇрЇА рѕўрѕЃріерѕѕріЏ рЅђрѕІ рІФрѕѕ рІерЅєрІ│ рЅђрѕѕрѕЮ
­Ъц╣­ЪЈ┐РђЇРЎѓ№ИЈ	рѕ░рІЇ рїђрїЇріЋрїЇ: рїЦрЅЂрѕГ рІерЅєрІ│ рЅђрѕѕрѕЮ
­Ъц╣­ЪЈ┐РђЇРЎѓ	рѕ░рІЇ рїђрїЇріЋрїЇ: рїЦрЅЂрѕГ рІерЅєрІ│ рЅђрѕѕрѕЮ
­Ъц╣РђЇРЎђ№ИЈ	рѕ┤рЅх ріЦрІерѕ«рїарЅй
­Ъц╣РђЇРЎђ	рѕ┤рЅх ріЦрІерѕ«рїарЅй
­Ъц╣­ЪЈ╗РђЇРЎђ№ИЈ	рѕ┤рЅх рїђрїЇріЋрїЇрЇА рЅђрѕІрѕЇ рІерЅєрІ│ рЅђрѕѕрѕЮ
­Ъц╣­ЪЈ╗РђЇРЎђ	рѕ┤рЅх рїђрїЇріЋрїЇрЇА рЅђрѕІрѕЇ рІерЅєрІ│ рЅђрѕѕрѕЮ
­Ъц╣­ЪЈ╝РђЇРЎђ№ИЈ	рѕ┤рЅх рїђрїЇріЋрїЇрЇА рѕўрѕЃріерѕѕріЏ рЅђрѕІ рІФрѕѕ рІерЅєрІ│ рЅђрѕѕрѕЮ
­Ъц╣­ЪЈ╝РђЇРЎђ	рѕ┤рЅх рїђрїЇріЋрїЇрЇА рѕўрѕЃріерѕѕріЏ рЅђрѕІ рІФрѕѕ рІерЅєрІ│ рЅђрѕѕрѕЮ
­Ъц╣­ЪЈйРђЇРЎђ№ИЈ	рѕ┤рЅх рїђрїЇріЋрїЇ: рѕўрѕЃріерѕѕріЏ рІерЅєрІ│ рЅђрѕѕрѕЮ
­Ъц╣­ЪЈйРђЇРЎђ	рѕ┤рЅх рїђрїЇріЋрїЇ: рѕўрѕЃріерѕѕріЏ рІерЅєрІ│ рЅђрѕѕрѕЮ
­Ъц╣­ЪЈЙРђЇРЎђ№ИЈ	рѕ┤рЅх рїђрїЇріЋрїЇрЇА рѕўрѕЃріерѕѕріЏ рЅђрѕІ рІФрѕѕ рІерЅєрІ│ рЅђрѕѕрѕЮ
­Ъц╣­ЪЈЙРђЇРЎђ	рѕ┤рЅх рїђрїЇріЋрїЇрЇА рѕўрѕЃріерѕѕріЏ рЅђрѕІ рІФрѕѕ рІерЅєрІ│ рЅђрѕѕрѕЮ
­Ъц╣­ЪЈ┐РђЇРЎђ№ИЈ	рѕ┤рЅх рїђрїЇріЋрїЇ: рїЦрЅЂрѕГ рІерЅєрІ│ рЅђрѕѕрѕЮ
­Ъц╣­ЪЈ┐РђЇРЎђ	рѕ┤рЅх рїђрїЇріЋрїЇ: рїЦрЅЂрѕГ рІерЅєрІ│ рЅђрѕѕрѕЮ
­ЪЉФ	рІѕріЋрІхріЊ рѕ┤рЅх ріЦрїЁ рѕѕріЦрїЁ рЅ░рІФрІГрІўрІІрѕЇрЇб
­ЪЉг	рѕЂрѕѕрЅх рѕ░рІјрЅй ріЦрїЁ рѕѕріЦрїЁ рЅ░рІФрІГрІўрІІрѕЇрЇб
­ЪЉГ	рѕЂрѕѕрЅх рѕ┤рЅХрЅй ріЦрїЁ рѕѕріЦрїЁ рЅ░рІФрІГрІўрІІрѕЇрЇб
­ЪњЈ	рѕўрѕ│рѕЮ
­ЪЉЕРђЇРЮц№ИЈРђЇ­ЪњІРђЇ­ЪЉе	рѕўрѕ│рѕЮ: рѕ┤рЅх, рІѕріЋрІх
­ЪЉЕРђЇРЮцРђЇ­ЪњІРђЇ­ЪЉе	рѕўрѕ│рѕЮ: рѕ┤рЅх, рІѕріЋрІх
­ЪЉеРђЇРЮц№ИЈРђЇ­ЪњІРђЇ­ЪЉе	рѕўрѕ│рѕЮ: рѕ░рІЇ, рѕ░рІЇ
­ЪЉеРђЇРЮцРђЇ­ЪњІРђЇ­ЪЉе	рѕўрѕ│рѕЮ: рѕ░рІЇ, рѕ░рІЇ
­ЪЉЕРђЇРЮц№ИЈРђЇ­ЪњІРђЇ­ЪЉЕ	рѕўрѕ│рѕЮ: рѕ┤рЅх, рѕ┤рЅх
­ЪЉЕРђЇРЮцРђЇ­ЪњІРђЇ­ЪЉЕ	рѕўрѕ│рѕЮ: рѕ┤рЅх, рѕ┤рЅх
­ЪњЉ	рѕЇрЅЦ рІФрѕІрЅИрІЇ рЅБрѕЇріЊ рѕџрѕхрЅх
­ЪЉЕРђЇРЮц№ИЈРђЇ­ЪЉе	рѕЇрЅЦ рІФрѕІрЅИрІЇ рЅБрѕЇріЊ рѕџрѕхрЅх: рѕ┤рЅх, рІѕріЋрІх
­ЪЉЕРђЇРЮцРђЇ­ЪЉе	рѕЇрЅЦ рІФрѕІрЅИрІЇ рЅБрѕЇріЊ рѕџрѕхрЅх: рѕ┤рЅх, рІѕріЋрІх
­ЪЉеРђЇРЮц№ИЈРђЇ­ЪЉе	рѕЇрЅЦ рІФрѕІрЅИрІЇ рЅБрѕЇріЊ рѕџрѕхрЅх: рѕ░рІЇ, рѕ░рІЇ
­ЪЉеРђЇРЮцРђЇ­ЪЉе	рѕЇрЅЦ рІФрѕІрЅИрІЇ рЅБрѕЇріЊ рѕџрѕхрЅх: рѕ░рІЇ, рѕ░рІЇ
­ЪЉЕРђЇРЮц№ИЈРђЇ­ЪЉЕ	рѕЇрЅЦ рІФрѕІрЅИрІЇ рЅБрѕЇріЊ рѕџрѕхрЅх: рѕ┤рЅх, рѕ┤рЅх
­ЪЉЕРђЇРЮцРђЇ­ЪЉЕ	рѕЇрЅЦ рІФрѕІрЅИрІЇ рЅБрѕЇріЊ рѕџрѕхрЅх: рѕ┤рЅх, рѕ┤рЅх
­ЪЉф	рЅцрЅ░рѕ░рЅЦ
­ЪЉеРђЇ­ЪЉЕРђЇ­ЪЉд	рЅцрЅ░рѕ░рЅЦ: рІѕріЋрІх, рѕ┤рЅх, рІѕріЋрІх рѕЇрїЁ
­ЪЉеРђЇ­ЪЉЕРђЇ­ЪЉД	рЅцрЅ░рѕ░рЅЦ: рІѕріЋрІх, рѕ┤рЅх, рѕ┤рЅх рѕЇрїЁ
­ЪЉеРђЇ­ЪЉЕРђЇ­ЪЉДРђЇ­ЪЉд	рЅцрЅ░рѕ░рЅЦ: рІѕріЋрІх, рѕ┤рЅх, рѕ┤рЅх рѕЇрїЁ, рІѕріЋрІх рѕЇрїЁ
­ЪЉеРђЇ­ЪЉЕРђЇ­ЪЉдРђЇ­ЪЉд	рЅцрЅ░рѕ░рЅЦ: рІѕріЋрІх, рѕ┤рЅх, рІѕріЋрІх рѕЇрїЁ, рІѕріЋрІх рѕЇрїЁ
­ЪЉеРђЇ­ЪЉЕРђЇ­ЪЉДРђЇ­ЪЉД	рЅцрЅ░рѕ░рЅЦ: рІѕріЋрІх, рѕ┤рЅх, рѕ┤рЅх рѕЇрїЁ, рѕ┤рЅх рѕЇрїЁ
­ЪЉеРђЇ­ЪЉеРђЇ­ЪЉд	рЅцрЅ░рѕ░рЅЦ: рѕ░рІЇ, рІѕріЋрІх, рІѕріЋрІх рѕЇрїЁ
­ЪЉеРђЇ­ЪЉеРђЇ­ЪЉД	рЅцрЅ░рѕ░рЅЦ: рІѕріЋрІх, рІѕріЋрІх, рѕ┤рЅх рѕЇрїЁ
­ЪЉеРђЇ­ЪЉеРђЇ­ЪЉДРђЇ­ЪЉд	рЅцрЅ░рѕ░рЅЦ: рІѕріЋрІх, рІѕріЋрІх, рѕ┤рЅх рѕЇрїЁ, рІѕріЋрІх рѕЇрїЁ
­ЪЉеРђЇ­ЪЉеРђЇ­ЪЉдРђЇ­ЪЉд	рЅцрЅ░рѕ░рЅЦ: рѕ░рІЇ, рІѕріЋрІх, рІѕріЋрІх рѕЇрїЁ, рІѕріЋрІх рѕЇрїЁ
­ЪЉеРђЇ­ЪЉеРђЇ­ЪЉДРђЇ­ЪЉД	рЅцрЅ░рѕ░рЅЦ: рІѕріЋрІх, рІѕріЋрІх, рѕ┤рЅх рѕЇрїЁ, рѕ┤рЅх рѕЇрїЁ
­ЪЉЕРђЇ­ЪЉЕРђЇ­ЪЉд	рЅцрЅ░рѕ░рЅЦ: рѕ┤рЅх, рѕ┤рЅх, рІѕріЋрІх рѕЇрїЁ
­ЪЉЕРђЇ­ЪЉЕРђЇ­ЪЉД	рЅцрЅ░рѕ░рЅЦ: рѕ┤рЅх, рѕ┤рЅх, рѕ┤рЅх рѕЇрїЁ
­ЪЉЕРђЇ­ЪЉЕРђЇ­ЪЉДРђЇ­ЪЉд	рЅцрЅ░рѕ░рЅЦ: рѕ┤рЅх, рѕ┤рЅх, рѕ┤рЅх рѕЇрїЁ, рІѕріЋрІх рѕЇрїЁ
­ЪЉЕРђЇ­ЪЉЕРђЇ­ЪЉдРђЇ­ЪЉд	рЅцрЅ░рѕ░рЅЦ: рѕ┤рЅх, рѕ┤рЅх, рІѕріЋрІх рѕЇрїЁ, рІѕріЋрІх рѕЇрїЁ
­ЪЉЕРђЇ­ЪЉЕРђЇ­ЪЉДРђЇ­ЪЉД	рЅцрЅ░рѕ░рЅЦ: рѕ┤рЅх, рѕ┤рЅх, рѕ┤рЅх рѕЇрїЁ, рѕ┤рЅх рѕЇрїЁ
­ЪЉеРђЇ­ЪЉд	рЅцрЅ░рѕ░рЅЦ: рІѕріЋрІх, рІѕріЋрІх рѕЇрїЁ
­ЪЉеРђЇ­ЪЉдРђЇ­ЪЉд	рЅцрЅ░рѕ░рЅЦ: рІѕріЋрІх, рІѕріЋрІх рѕЇрїЁ, рІѕріЋрІх рѕЇрїЁ
­ЪЉеРђЇ­ЪЉД	рЅцрЅ░рѕ░рЅЦ: рІѕріЋрІх, рѕ┤рЅх рѕЇрїЁ
­ЪЉеРђЇ­ЪЉДРђЇ­ЪЉд	рЅцрЅ░рѕ░рЅЦ: рІѕріЋрІх, рѕ┤рЅх рѕЇрїЁ, рІѕріЋрІх рѕЇрїЁ
­ЪЉеРђЇ­ЪЉДРђЇ­ЪЉД	рЅцрЅ░рѕ░рЅЦ: рІѕріЋрІх, рѕ┤рЅх рѕЇрїЁ, рѕ┤рЅх рѕЇрїЁ
­ЪЉЕРђЇ­ЪЉд	рЅцрЅ░рѕ░рЅЦ: рѕ┤рЅх, рІѕріЋрІх рѕЇрїЁ
­ЪЉЕРђЇ­ЪЉдРђЇ­ЪЉд	рЅцрЅ░рѕ░рЅЦ: рѕ┤рЅх, рІѕріЋрІх рѕЇрїЁ, рІѕріЋрІх рѕЇрїЁ
­ЪЉЕРђЇ­ЪЉД	рЅцрЅ░рѕ░рЅЦ: рѕ┤рЅх, рѕ┤рЅх рѕЇрїЁ
­ЪЉЕРђЇ­ЪЉДРђЇ­ЪЉд	рЅцрЅ░рѕ░рЅЦ: рѕ┤рЅх, рѕ┤рЅх рѕЇрїЁ, рІѕріЋрІх рѕЇрїЁ
­ЪЉЕРђЇ­ЪЉДРђЇ­ЪЉД	рЅцрЅ░рѕ░рЅЦ: рѕ┤рЅх, рѕ┤рЅх рѕЇрїЁ, рѕ┤рЅх рѕЇрїЁ
­Ъц│	рІерѕФрѕх рЇјрЅХ
­Ъц│­ЪЈ╗	рІерѕФрѕх рЇјрЅХрЇА рЅђрѕІрѕЇ рІерЅєрІ│ рЅђрѕѕрѕЮ
­Ъц│­ЪЈ╝	рІерѕФрѕх рЇјрЅХрЇА рѕўрѕЃріерѕѕріЏ рЅђрѕІ рІФрѕѕ рІерЅєрІ│ рЅђрѕѕрѕЮ
­Ъц│­ЪЈй	рІерѕФрѕх рЇјрЅХрЇА рѕўрѕЃріерѕѕріЏ рІерЅєрІ│ рЅђрѕѕрѕЮ
­Ъц│­ЪЈЙ	рІерѕФрѕх рЇјрЅХрЇА рѕўрѕЃріерѕѕріЏ рЅђрѕІ рІФрѕѕ рІерЅєрІ│ рЅђрѕѕрѕЮ
­Ъц│­ЪЈ┐	рІерѕФрѕх рЇјрЅХрЇА рїЦрЅЂрѕГ рІерЅєрІ│ рЅђрѕѕрѕЮ
­Ъњф	рЅ░рїБрїБрЇі рЅбрѕ┤рЇЋрѕх
­Ъњф­ЪЈ╗	рЅ░рїБрїБрЇі рЅбрѕ┤рЇЋрѕхрЇА рЅђрѕІрѕЇ рІерЅєрІ│ рЅђрѕѕрѕЮ
­Ъњф­ЪЈ╝	рЅ░рїБрїБрЇі рЅбрѕ┤рЇЋрѕхрЇА рѕўрѕЃріерѕѕріЏ рЅђрѕІ рІФрѕѕ рІерЅєрІ│ рЅђрѕѕрѕЮ
­Ъњф­ЪЈй	рЅ░рїБрїБрЇі рЅбрѕ┤рЇЋрѕхрЇА рѕўрѕЃріерѕѕріЏ рІерЅєрІ│ рЅђрѕѕрѕЮ
­Ъњф­ЪЈЙ	рЅ░рїБрїБрЇі рЅбрѕ┤рЇЋрѕхрЇА рѕўрѕЃріерѕѕріЏ рЅђрѕІ рІФрѕѕ рІерЅєрІ│ рЅђрѕѕрѕЮ
­Ъњф­ЪЈ┐	рІерЅ░рїБрїБрѕў рЅбрѕхрЇЋрѕх: рїЦрЅЂрѕГ рІерЅєрІ│ рЅђрѕѕрѕЮ
­Ъдх	ріЦрїЇрѕГ
­Ъдх­ЪЈ╗	ріЦрїЇрѕГ: рЅђрѕІрѕЇ рІерЅєрІ│ рЅђрѕѕрѕЮ
­Ъдх­ЪЈ╝	ріЦрїЇрѕГ: рѕўрѕЃріерѕѕріЏ рЅђрѕІ рІФрѕѕ рІерЅєрІ│ рЅђрѕѕрѕЮ
­Ъдх­ЪЈй	ріЦрїЇрѕГ: рѕўрѕЃріерѕѕріЏ рІерЅєрІ│ рЅђрѕѕрѕЮ
­Ъдх­ЪЈЙ	ріЦрїЇрѕГ: рѕўрѕЃріерѕѕріЏ-рїЦрЅЂрѕГ рІерЅєрІ│ рЅђрѕѕрѕЮ
­Ъдх­ЪЈ┐	ріЦрїЇрѕГ: рїЦрЅЂрѕГ рІерЅєрІ│ рЅђрѕѕрѕЮ
­ЪдХ	ріЦрїЇрѕГ
­ЪдХ­ЪЈ╗	ріЦрїЇрѕГ: рЅђрѕІрѕЇ рІерЅєрІ│ рЅђрѕѕрѕЮ
­ЪдХ­ЪЈ╝	ріЦрїЇрѕГ: рѕўрѕЃріерѕѕріЏ рЅђрѕІ рІФрѕѕ рІерЅєрІ│ рЅђрѕѕрѕЮ
­ЪдХ­ЪЈй	ріЦрїЇрѕГ: рѕўрѕЃріерѕѕріЏ рІерЅєрІ│ рЅђрѕѕрѕЮ
­ЪдХ­ЪЈЙ	ріЦрїЇрѕГ: рѕўрѕЃріерѕѕріЏ-рїЦрЅЂрѕГ рІерЅєрІ│ рЅђрѕѕрѕЮ
­ЪдХ­ЪЈ┐	ріЦрїЇрѕГ: рїЦрЅЂрѕГ рІерЅєрІ│ рЅђрѕѕрѕЮ
­ЪЉѕ	рІѕрІ░ рїЇрѕФ рІерѕџрІФрѕўрѕѕріГрЅ░рІЇ рІеріІрѕІ ріЦрїЁ рѕўрѕерїЃ рїарЅІрѕџ
­ЪЉѕ­ЪЈ╗	рІѕрІ░ рїЇрѕФ рІерѕџрІФрѕўрѕѕріГрЅ░рІЇ рІеріІрѕІ ріЦрїЁ рѕўрѕерїЃ рїарЅІрѕџрЇА рЅђрѕІрѕЇ рІерЅєрІ│ рЅђрѕѕрѕЮ
­ЪЉѕ­ЪЈ╝	рІѕрІ░ рїЇрѕФ рІерѕџрІФрѕўрѕѕріГрЅ░рІЇ рІеріІрѕІ ріЦрїЁ рѕўрѕерїЃ рїарЅІрѕџрЇА рѕўрѕЃріерѕѕріЏ рЅђрѕІ рІФрѕѕ рІерЅєрІ│ рЅђрѕѕрѕЮ
­ЪЉѕ­ЪЈй	рІѕрІ░ рїЇрѕФ рІерѕџрІФрѕўрѕѕріГрЅх рІеріІрѕІ ріЦрїЁ рѕўрѕерїЃ рїарЅІрѕџрЇА рѕўрѕЃріерѕѕріЏ рІерЅєрІ│ рЅђрѕѕрѕЮ
­ЪЉѕ­ЪЈЙ	рІѕрІ░ рїЇрѕФ рІерѕџрІФрѕўрѕѕріГрЅх рІеріІрѕІ ріЦрїЁ рѕўрѕерїЃ рїарЅІрѕџрЇА рѕўрѕЃріерѕѕріЏ рЅђрѕІ рІФрѕѕ рІерЅєрІ│ рЅђрѕѕрѕЮ
­ЪЉѕ­ЪЈ┐	рІеріІрѕІ ріЦрїЁ рѕўрѕерїЃ рїарЅІрѕџ рІѕрІ░ рїЇрѕФ рІерѕџрІФрѕўрѕѕріГрЅхрЇА рїЦрЅЂрѕГ рІерЅєрІ│ рЅђрѕѕрѕЮ
­ЪЉЅ	рІѕрІ░ рЅђріЮ рІерѕџрІФрѕўрѕѕріГрЅх рІеріІрѕІ ріЦрїЁ рѕўрѕерїЃ рїарЅІрѕџ
­ЪЉЅ­ЪЈ╗	рІеріІрѕІ ріЦрїЁ рѕўрѕерїЃ рїарЅІрѕџ рІѕрІ░ рЅђріЮ рІерѕџрІФрѕўрѕѕріГрЅхрЇА рЅђрѕІрѕЇ рІерЅєрІ│ рЅђрѕѕрѕЮ
­ЪЉЅ­ЪЈ╝	рІеріІрѕІ ріЦрїЁ рѕўрѕерїЃ рїарЅІрѕџ рІѕрІ░ рЅђріЮ рІерѕџрІФрѕўрѕѕріГрЅхрЇА рѕўрѕЃріерѕѕріЏ рЅђрѕІ рІФрѕѕ рІерЅєрІ│ рЅђрѕѕрѕЮ
­ЪЉЅ­ЪЈй	рІеріІрѕІ ріЦрїЁ рѕўрѕерїЃ рїарЅІрѕџ рІѕрІ░ рЅђріЮ рІерѕџрІФрѕўрѕѕріГрЅхрЇА рѕўрѕЃріерѕѕріЏ рІерЅєрІ│ рЅђрѕѕрѕЮ
­ЪЉЅ­ЪЈЙ	рІеріІрѕІ ріЦрїЁ рѕўрѕерїЃ рїарЅІрѕџ рІѕрІ░ рЅђріЮ рІерѕџрІФрѕўрѕѕріГрЅхрЇА рѕўрѕЃріерѕѕріЏ рЅђрѕІ рІФрѕѕ рІерЅєрІ│ рЅђрѕѕрѕЮ
­ЪЉЅ­ЪЈ┐	рІеріІрѕІ ріЦрїЁ рѕўрѕерїЃ рїарЅІрѕџ рІѕрІ░ рЅђріЮ рІерѕџрІФрѕўрѕѕріГрЅхрЇА рїЦрЅЂрѕГ рІерЅєрІ│ рЅђрѕѕрѕЮ
РўЮ№ИЈ	рїарЅІрѕџ рІѕрІ░ рѕІрІГ ріЦрІерїарЅєрѕў
РўЮ	рїарЅІрѕџ рІѕрІ░ рѕІрІГ ріЦрІерїарЅєрѕў
РўЮ­ЪЈ╗	рїарЅІрѕџ рІѕрІ░рѕІрІГ ріЦрІерїарЅєрѕўрЇА рЅђрѕІрѕЇ рІерЅєрІ│ рЅђрѕѕрѕЮ
РўЮ­ЪЈ╝	рїарЅІрѕџ рІѕрІ░ рѕІрІГ: рѕўрѕЃріерѕѕріЏ рЅђрѕІ рІФрѕѕ рІерЅєрІ│ рЅђрѕѕрѕЮ
РўЮ­ЪЈй	рїарЅІрѕџ рІѕрІ░ рѕІрІГ: рѕўрѕЃріерѕѕріЏ рІерЅєрІ│ рЅђрѕѕрѕЮ
РўЮ­ЪЈЙ	рїарЅІрѕџ рІѕрІ░ рѕІрІГ: рѕўрѕЃріерѕѕріЏ-рїЦрЅЂрѕГ рІерЅєрІ│ рЅђрѕѕрѕЮ
РўЮ­ЪЈ┐	рїарЅІрѕџ рІѕрІ░ рѕІрІГ: рїЦрЅЂрѕГ рІерЅєрІ│ рЅђрѕѕрѕЮ
­ЪЉє	рІеріІрѕІ ріЦрїЁ рѕўрѕерїЃ рїарЅІрѕџ рІѕрІ░ рѕІрІГ рІФрѕ│рІФрѕЇ
­ЪЉє­ЪЈ╗	рІеріІрѕІ ріЦрїЁ рѕўрѕерїЃ рїарЅІрѕџ рІѕрІ░ рѕІрІГ ріЦрІерїарЅєрѕўрЇА рЅђрѕІрѕЇ рІерЅєрІ│ рЅђрѕѕрѕЮ
­ЪЉє­ЪЈ╝	рІеріІрѕІ ріЦрїЁ рѕўрѕерїЃ рїарЅІрѕџ рІѕрІ░ рѕІрІГ ріЦрІерїарЅєрѕўрЇА рѕўрѕЃріерѕѕріЏ рЅђрѕІ рІФрѕѕ рІерЅєрІ│ рЅђрѕѕрѕЮ
­ЪЉє­ЪЈй	рІеріІрѕІ ріЦрїЁ рѕўрѕерїЃ рїарЅІрѕџ рІѕрІ░ рѕІрІГ ріЦрІерїарЅєрѕўрЇА рѕўрѕЃріерѕѕріЏ рІерЅєрІ│ рЅђрѕѕрѕЮ
­ЪЉє­ЪЈЙ	рІеріІрѕІ ріЦрїЁ рѕўрѕерїЃ рїарЅІрѕџ рІѕрІ░ рѕІрІГ ріЦрІерїарЅєрѕўрЇА рѕўрѕЃріерѕѕріЏ рЅђрѕІ рІФрѕѕ рІерЅєрІ│ рЅђрѕѕрѕЮ
­ЪЉє­ЪЈ┐	рІеріІрѕІ ріЦрїЁ рѕўрѕерїЃ рїарЅІрѕџ рІѕрІ░ рѕІрІГ ріЦрІерїарЅєрѕўрЇА рїЦрЅЂрѕГ рІерЅєрІ│ рЅђрѕѕрѕЮ
­ЪќЋ	рѕўріФріерѕѕріЏ рїБрЅх
­ЪќЋ­ЪЈ╗	рІерѕўрѕЃрѕЇ рїБрЅх: рЅђрѕІрѕЇ рІерЅєрІ│ рЅђрѕѕрѕЮ
­ЪќЋ­ЪЈ╝	рІерѕўрѕЃрѕЇ рїБрЅхрЇА рѕўрѕЃріерѕѕріЏ рЅђрѕІ рІФрѕѕ рІерЅєрІ│ рЅђрѕѕрѕЮ
­ЪќЋ­ЪЈй	рѕўріФріерѕѕріЏ рїБрЅх: рѕўрѕЃріерѕѕріЏ рІерЅєрІ│ рЅђрѕѕрѕЮ
­ЪќЋ­ЪЈЙ	рІерѕўрѕЃрѕЇ рїБрЅх: рѕўрѕЃріерѕѕріЏ-рїЦрЅЂрѕГ рІерЅєрІ│ рЅђрѕѕрѕЮ
­ЪќЋ­ЪЈ┐	рІерѕўрѕЃрѕЇ рїБрЅх: рїЦрЅЂрѕГ рІерЅєрІ│ рЅђрѕѕрѕЮ
­ЪЉЄ	рІѕрІ░ рЅ│рЅй рІерѕџрІФрѕўрѕѕріГрЅх рІеріІрѕІ ріЦрїЁ рѕўрѕерїЃ рїарЅІрѕџ
­ЪЉЄ­ЪЈ╗	рІѕрІ░ рЅ│рЅй рІерѕџрІФрѕўрѕѕріГрЅх рІеріІрѕІ ріЦрїЁ рѕўрѕерїЃ рїарЅІрѕџрЇА рЅђрѕІрѕЇ рІерЅєрІ│ рЅђрѕѕрѕЮ
­ЪЉЄ­ЪЈ╝	рІѕрІ░ рЅ│рЅй рІерѕџрІФрѕўрѕѕріГрЅх рІеріІрѕІ ріЦрїЁ рѕўрѕерїЃ рїарЅІрѕџрЇА рѕўрѕЃріерѕѕріЏ рЅђрѕІ рІФрѕѕ рІерЅєрІ│ рЅђрѕѕрѕЮ
­ЪЉЄ­ЪЈй	рІѕрІ░ рЅ│рЅй рІерѕџрІФрѕўрѕѕріГрЅх рІеріІрѕІ ріЦрїЁ рѕўрѕерїЃ рїарЅІрѕџрЇА рѕўрѕЃріерѕѕріЏ рІерЅєрІ│ рЅђрѕѕрѕЮ
­ЪЉЄ­ЪЈЙ	рІѕрІ░ рЅ│рЅй рІерѕџрІФрѕўрѕѕріГрЅх рІеріІрѕІ ріЦрїЁ рѕўрѕерїЃ рїарЅІрѕџрЇА рѕўрѕЃріерѕѕріЏ рЅђрѕІ рІФрѕѕ рІерЅєрІ│ рЅђрѕѕрѕЮ
­ЪЉЄ­ЪЈ┐	рІѕрІ░ рЅ│рЅй рІерѕџрІФрѕўрѕѕріГрЅх рІеріІрѕІ ріЦрїЁ рѕўрѕерїЃ рїарЅІрѕџрЇА рїЦрЅЂрѕГ рІерЅєрІ│ рЅђрѕѕрѕЮ
Рюї№ИЈ	рІерІхрѕЇ ріЦрїЁ
Рюї	рІерІхрѕЇ ріЦрїЁ
Рюї­ЪЈ╗	рІерІхрѕЇ ріЦрїЁ: рЅђрѕІрѕЇ рІерЅєрІ│ рЅђрѕѕрѕЮ
Рюї­ЪЈ╝	рІерІхрѕЇ ріЦрїЁ: рѕўрѕЃріерѕѕріЏ рЅђрѕІ рІФрѕѕ рІерЅєрІ│ рЅђрѕѕрѕЮ
Рюї­ЪЈй	рІерІхрѕЇ ріЦрїЁ: рѕўрѕЃріерѕѕріЏ рІерЅєрІ│ рЅђрѕѕрѕЮ
Рюї­ЪЈЙ	рІерІхрѕЇ ріЦрїЁ: рѕўрѕЃріерѕѕріЏ-рїЦрЅЂрѕГ рІерЅєрІ│ рЅђрѕѕрѕЮ
Рюї­ЪЈ┐	рІерІхрѕЇ ріЦрїЁ: рїЦрЅЂрѕГ рІерЅєрІ│ рЅђрѕѕрѕЮ
­Ъцъ	рІерЅ░рѕ╗рїѕрѕЕ рїБрЅХрЅй
­Ъцъ­ЪЈ╗	рІерЅ░рѕ╗рїѕрѕЕ рїБрЅХрЅй: рЅђрѕІрѕЇ рІерЅєрІ│ рЅђрѕѕрѕЮ
­Ъцъ­ЪЈ╝	рІерЅ░рѕ╗рїѕрѕЕ рїБрЅХрЅй: рѕўрѕЃріерѕѕріЏ рЅђрѕІ рІФрѕѕ рІерЅєрІ│ рЅђрѕѕрѕЮ
­Ъцъ­ЪЈй	рІерЅ░рѕ╗рїѕрѕЕ рїБрЅХрЅй: рѕўрѕЃріерѕѕріЏ рІерЅєрІ│ рЅђрѕѕрѕЮ
­Ъцъ­ЪЈЙ	рІерЅ░рѕ╗рїѕрѕЕ рїБрЅХрЅй: рѕўрѕЃріерѕѕріЏ-рїЦрЅЂрѕГ рІерЅєрІ│ рЅђрѕѕрѕЮ
­Ъцъ­ЪЈ┐	рІерЅ░рѕ╗рїѕрѕЕ рїБрЅХрЅй: рїЦрЅЂрѕГ рІерЅєрІ│ рЅђрѕѕрѕЮ
­Ъќќ	vulcan рѕ░рѕІрѕЮрЅ│
­Ъќќ­ЪЈ╗	vulcan рѕ░рѕІрѕЮрЅ│рЇА рЅђрѕІрѕЇ рІерЅєрІ│ рЅђрѕѕрѕЮ
­Ъќќ­ЪЈ╝	рІерЅ«рѕЇріФріЋ рѕ░рѕІрѕЮрЅ│рЇА рѕўрѕЃріерѕѕріЏ рЅђрѕІ рІФрѕѕ рІерЅєрІ│ рЅђрѕѕрѕЮ
­Ъќќ­ЪЈй	vulcan рѕ░рѕІрѕЮрЅ│рЇА рѕўрѕЃріерѕѕріЏ рІерЅєрІ│ рЅђрѕѕрѕЮ
­Ъќќ­ЪЈЙ	рІерЅ«рѕЇріФріЋ рѕ░рѕІрѕЮрЅ│рЇА рѕўрѕЃріерѕѕріЏ рЅђрѕІ рІФрѕѕ рІерЅєрІ│ рЅђрѕѕрѕЮ
­Ъќќ­ЪЈ┐	vulcan рѕ░рѕІрѕЮрЅ│: рїЦрЅЂрѕГ рІерЅєрІ│ рЅђрѕѕрѕЮ
­Ъцў	рІерЅђріЋрІХрЅй рѕЮрѕЇріГрЅх
­Ъцў­ЪЈ╗	рІерЅђріЋрІХрЅй рѕЮрѕЇріГрЅх: рЅђрѕІрѕЇ рІерЅєрІ│ рЅђрѕѕрѕЮ
­Ъцў­ЪЈ╝	рІерЅђріЋрІХрЅй рѕЮрѕЇріГрЅх: рѕўрѕЃріерѕѕріЏ рЅђрѕІ рІФрѕѕ рІерЅєрІ│ рЅђрѕѕрѕЮ
­Ъцў­ЪЈй	рІерЅђріЋрІХрЅй рѕЮрѕЇріГрЅх: рѕўрѕЃріерѕѕріЏ рІерЅєрІ│ рЅђрѕѕрѕЮ
­Ъцў­ЪЈЙ	рІерЅђріЋрІХрЅй рѕЮрѕЇріГрЅх: рѕўрѕЃріерѕѕріЏ-рїЦрЅЂрѕГ рІерЅєрІ│ рЅђрѕѕрѕЮ
­Ъцў­ЪЈ┐	рІерЅђріЋрІХрЅй рѕЮрѕЇріГрЅх: рїЦрЅЂрѕГ рІерЅєрІ│ рЅђрѕѕрѕЮ
­ЪцЎ	ріЦрїёріЋ рїЦрѕФріЮ
­ЪцЎ­ЪЈ╗	ріЦрїёріЋ рїЦрѕФріЮрЇА рЅђрѕІрѕЇ рІерЅєрІ│ рЅђрѕѕрѕЮ
­ЪцЎ­ЪЈ╝	рІеріЦрїЁ рІ░рІЇрѕЇрѕЇріЮрЇА рѕўрѕЃріерѕѕріЏ рЅђрѕІ рІФрѕѕ рІерЅєрІ│ рЅђрѕѕрѕЮ
­ЪцЎ­ЪЈй	рІеріЦрїЁ рІ░рІЇрѕЇрѕЇріЮрЇА рѕўрѕЃріерѕѕріЏ рІерЅєрІ│ рЅђрѕѕрѕЮ
­ЪцЎ­ЪЈЙ	рІеріЦрїЁ рІ░рІЇрѕЇрѕЇріЮрЇА рѕўрѕЃріерѕѕріЏ рЅђрѕІ рІФрѕѕ рІерЅєрІ│ рЅђрѕѕрѕЮ
­ЪцЎ­ЪЈ┐	ріЦрїёріЋ рїЦрѕФріЮ: рїЦрЅЂрѕГ рІерЅєрІ│ рЅђрѕѕрѕЮ
­Ъќљ№ИЈ	рЅарїБрЅХрЅй рІерЅ░рІѕрІЏрІѕрІЎ ріЦрїЁ
­Ъќљ	рЅарїБрЅХрЅй рІерЅ░рІѕрІЏрІѕрІЎ ріЦрїЁ
­Ъќљ­ЪЈ╗	ріЦрїЁ рЅарїБрЅХрЅй рІерЅ░рІѕрІЏрІѕрІў: рЅђрѕІрѕЇ рІерЅєрІ│ рЅђрѕѕрѕЮ
­Ъќљ­ЪЈ╝	ріЦрїЁ рЅарїБрЅХрЅй рІерЅ░рІѕрїарѕерЇА рѕўрѕЃріерѕѕріЏ рЅђрѕІ рІФрѕѕ рІерЅєрІ│ рЅђрѕѕрѕЮ
­Ъќљ­ЪЈй	ріЦрїЁ рЅарїБрЅХрЅй рЅ░рІўрѕГрїЇрЅирѕЇ: рѕўрѕЃріерѕѕріЏ рІерЅєрІ│ рЅђрѕѕрѕЮ
­Ъќљ­ЪЈЙ	ріЦрїЁ рЅарїБрЅХрЅй рІерЅ░рІўрѕерїІ: рѕўрѕЃріерѕѕріЏ-рїЦрЅЂрѕГ рІерЅєрІ│ рЅђрѕѕрѕЮ
­Ъќљ­ЪЈ┐	ріЦрїЁ рЅарїБрЅХрЅй рІерЅ░рІѕрІЏрІѕрІў: рїЦрЅЂрѕГ рІерЅєрІ│ рЅђрѕѕрѕЮ
РюІ	рІерЅ░рІўрѕерїІ ріЦрїЁ
РюІ­ЪЈ╗	ріерЇЇ рІФрѕѕ ріЦрїЁ: рЅђрѕІрѕЇ рІерЅєрІ│ рЅђрѕѕрѕЮ
РюІ­ЪЈ╝	ріерЇЇ рІФрѕѕ ріЦрїЁ: рѕўрѕЃріерѕѕріЏ рЅђрѕІ рІФрѕѕ рІерЅєрІ│ рЅђрѕѕрѕЮ
РюІ­ЪЈй	ріерЇЇ рІФрѕѕ ріЦрїЁ: рѕўрѕЃріерѕѕріЏ рІерЅєрІ│ рЅђрѕѕрѕЮ
РюІ­ЪЈЙ	ріерЇЇ рІФрѕѕ ріЦрїЁ: рѕўрѕЃріерѕѕріЏ-рїЦрЅЂрѕГ рІерЅєрІ│ рЅђрѕѕрѕЮ
РюІ­ЪЈ┐	ріерЇЇ рІФрѕѕ ріЦрїЁ: рїЦрЅЂрѕГ рІерЅєрІ│ рЅђрѕѕрѕЮ
­ЪЉї	ріЦрѕ║ ріЦрїЁ
­ЪЉї­ЪЈ╗	ріЦрѕ║ ріЦрїЁрЇА рЅђрѕІрѕЇ рІерЅєрІ│ рЅђрѕѕрѕЮ
­ЪЉї­ЪЈ╝	ріЦрѕ║ ріЦрїЁрЇА рѕўрѕЃріерѕѕріЏ рЅђрѕІ рІФрѕѕ рІерЅєрІ│ рЅђрѕѕрѕЮ
­ЪЉї­ЪЈй	ріЦрѕ║ ріЦрїЁрЇА рѕўрѕЃріерѕѕріЏ рІерЅєрІ│ рЅђрѕѕрѕЮ
­ЪЉї­ЪЈЙ	ріЦрѕ║ ріЦрїЁрЇА рѕўрѕЃріерѕѕріЏ рЅђрѕІ рІФрѕѕ рІерЅєрІ│ рЅђрѕѕрѕЮ
­ЪЉї­ЪЈ┐	ріЦрѕ║ ріЦрїЁрЇА рїЦрЅЂрѕГ рІерЅєрІ│ рЅђрѕѕрѕЮ
­ЪЉЇ	ріарІЇрѕФ рїБрЅх рІѕрІ░ рѕІрІГ
­ЪЉЇ­ЪЈ╗	ріарІЇрѕФ рїБрЅх: рЅђрѕІрѕЇ рІерЅєрІ│ рЅђрѕѕрѕЮ
­ЪЉЇ­ЪЈ╝	ріарІЇрѕФ рїБрЅх: рѕўрѕЃріерѕѕріЏ рЅђрѕІ рІФрѕѕ рІерЅєрІ│ рЅђрѕѕрѕЮ
­ЪЉЇ­ЪЈй	ріарІЇрѕФ рїБрЅх: рѕўрѕЃріерѕѕріЏ рІерЅєрІ│ рЅђрѕѕрѕЮ
­ЪЉЇ­ЪЈЙ	ріарІЇрѕФ рїБрЅх: рѕўрѕЃріерѕѕріЏ-рїЦрЅЂрѕГ рІерЅєрІ│ рЅђрѕѕрѕЮ
­ЪЉЇ­ЪЈ┐	ріарІЇрѕФ рїБрЅх: рїЦрЅЂрѕГ рІерЅєрІ│ рЅђрѕѕрѕЮ
­ЪЉј	рІ░рЅБрѕф
­ЪЉј­ЪЈ╗	ріарІЇрѕФ рїБрЅх: рЅђрѕІрѕЇ рІерЅєрІ│ рЅђрѕѕрѕЮ
­ЪЉј­ЪЈ╝	ріарІЇрѕФ рїБрЅх: рѕўрѕЃріерѕѕріЏ рЅђрѕІ рІФрѕѕ рІерЅєрІ│ рЅђрѕѕрѕЮ
­ЪЉј­ЪЈй	ріарІЇрѕФ рїБрЅх: рѕўрѕЃріерѕѕріЏ рІерЅєрІ│ рЅђрѕѕрѕЮ
­ЪЉј­ЪЈЙ	ріарІЇрѕФ рїБрЅх рІѕрІ░ рЅ│рЅйрЇА рѕўрѕЃріерѕѕріЏ рЅђрѕІ рІФрѕѕ рІерЅєрІ│ рЅђрѕѕрѕЮ
­ЪЉј­ЪЈ┐	ріарІЇрѕФ рїБрЅх: рїЦрЅЂрѕГ рІерЅєрІ│ рЅђрѕѕрѕЮ
Рюі	рІерЅ░ріљрѕБ рЅАрїб
Рюі­ЪЈ╗	ріерЇЇ рІФрѕѕ рїАрїФ: рЅђрѕІрѕЇ рІерЅєрІ│ рЅђрѕѕрѕЮ
Рюі­ЪЈ╝	ріерЇЇ рІФрѕѕ рїАрїФрЇА рѕўрѕЃріерѕѕріЏ рЅђрѕІ рІФрѕѕ рІерЅєрІ│ рЅђрѕѕрѕЮ
Рюі­ЪЈй	ріерЇЇ рІФрѕѕ рїАрїФ: рѕўрѕЃріерѕѕріЏ рІерЅєрІ│ рЅђрѕѕрѕЮ
Рюі­ЪЈЙ	ріерЇЇ рІФрѕѕ рЅАрїб: рѕўрѕЃріерѕѕріЏ-рїЦрЅЂрѕГ рІерЅєрІ│ рЅђрѕѕрѕЮ
Рюі­ЪЈ┐	ріерЇЇ рІФрѕѕ рЅАрїб: рїЦрЅЂрѕГ рІерЅєрІ│ рЅђрѕѕрѕЮ
­ЪЉі	рІерѕџрѕўрїБрІЇ рЅАрїб
­ЪЉі­ЪЈ╗	рІерѕџрѕўрїБрІЇ рЅАрїб: рЅђрѕІрѕЇ рІерЅєрІ│ рЅђрѕѕрѕЮ
­ЪЉі­ЪЈ╝	рІерѕџрѕўрїБрІЇ рЅАрїбрЇА рѕўрѕЃріерѕѕріЏ рЅђрѕІ рІФрѕѕ рІерЅєрІ│ рЅђрѕѕрѕЮ
­ЪЉі­ЪЈй	рІерѕџрѕўрїБрІЇ рЅАрїб: рѕўрѕЃріерѕѕріЏ рІерЅєрІ│ рЅђрѕѕрѕЮ
­ЪЉі­ЪЈЙ	рІерѕџрѕўрїБрІЇ рЅАрїб: рѕўрѕЃріерѕѕріЏ-рїЦрЅЂрѕГ рІерЅєрІ│ рЅђрѕѕрѕЮ
­ЪЉі­ЪЈ┐	рІерѕџрѕўрїБрІЇ рЅАрїб: рїЦрЅЂрѕГ рІерЅєрІ│ рЅђрѕѕрѕЮ
­ЪцЏ	рЅарїЇрѕФ рЅаріЕрѕЇ рІФрѕѕрІЇ рЅАрїб
­ЪцЏ­ЪЈ╗	рІѕрІ░ рїЇрѕФ рІерѕџрІФрІГ рїАрїФрЇА рЅђрѕІрѕЇ рІерЅєрІ│ рЅђрѕѕрѕЮ
­ЪцЏ­ЪЈ╝	рІѕрІ░ рїЇрѕФ рІерѕџрІФрІГ рїАрїФрЇА рѕўрѕЃріерѕѕріЏ рЅђрѕІ рІФрѕѕ рІерЅєрІ│ рЅђрѕѕрѕЮ
­ЪцЏ­ЪЈй	рІѕрІ░ рїЇрѕФ рІерѕџрІФрІГ рїАрїФрЇА рѕўрѕЃріерѕѕріЏ рІерЅєрІ│ рЅђрѕѕрѕЮ
­ЪцЏ­ЪЈЙ	рІѕрІ░ рїЇрѕФ рІерѕџрІФрІГ рїАрїФрЇА рѕўрѕЃріерѕѕріЏ рЅђрѕІ рІФрѕѕ рІерЅєрІ│ рЅђрѕѕрѕЮ
­ЪцЏ­ЪЈ┐	рІѕрІ░ рїЇрѕФ рІерѕџрІФрІГ рїАрїФрЇА рїЦрЅЂрѕГ рІерЅєрІ│ рЅђрѕѕрѕЮ
­Ъцю	рЅђріЮ-рЇірЅх рїАрїФ
­Ъцю­ЪЈ╗	рІѕрІ░ рЅђріЮ рІерѕџрІърѕГ рїАрїФрЇА рЅђрѕІрѕЇ рІерЅєрІ│ рЅђрѕѕрѕЮ
­Ъцю­ЪЈ╝	рЅђріЮ-рЇірЅх рїАрїФрЇА рѕўрѕЃріерѕѕріЏ рЅђрѕІ рІФрѕѕ рІерЅєрІ│ рЅђрѕѕрѕЮ
­Ъцю­ЪЈй	рІѕрІ░ рЅђріЮ рІерѕџрІърѕГ рїАрїФрЇА рѕўрѕЃріерѕѕріЏ рІерЅєрІ│ рЅђрѕѕрѕЮ
­Ъцю­ЪЈЙ	рЅђріЮ-рЇірЅх рїАрїФрЇА рѕўрѕЃріерѕѕріЏ рЅђрѕІ рІФрѕѕ рІерЅєрІ│ рЅђрѕѕрѕЮ
­Ъцю­ЪЈ┐	рІѕрІ░ рЅђріЮ рІерѕџрІърѕГ рїАрїФрЇА рїЦрЅЂрѕГ рІерЅєрІ│ рЅђрѕѕрѕЮ
­Ъцџ	рІѕрІ░ ріІрѕІ рЅ░ріљрѕхрЅирѕЇ
­Ъцџ­ЪЈ╗	ріерЇЇ рІФрѕѕ рІеріЦрїЁ рїђрѕГрЅБ: рЅђрѕІрѕЇ рІерЅєрІ│ рЅђрѕѕрѕЮ
­Ъцџ­ЪЈ╝	ріерЇЇ рІФрѕѕ рІеріЦрїЁ рїђрѕГрЅБрЇА рѕўрѕЃріерѕѕріЏ рЅђрѕІ рІФрѕѕ рІерЅєрІ│ рЅђрѕѕрѕЮ
­Ъцџ­ЪЈй	ріерЇЇ рІФрѕѕ рІеріЦрїЁ рїђрѕГрЅБ: рѕўрѕЃріерѕѕріЏ рІерЅєрІ│ рЅђрѕѕрѕЮ
­Ъцџ­ЪЈЙ	ріерЇЇ рІФрѕѕ рІеріЦрїЁ рїђрѕГрЅБ: рѕўрѕЃріерѕѕріЏ-рїЦрЅЂрѕГ рІерЅєрІ│ рЅђрѕѕрѕЮ
­Ъцџ­ЪЈ┐	ріерЇЇ рІФрѕѕ рІеріЦрїЁ рїђрѕГрЅБ: рїЦрЅЂрѕГ рІерЅєрІ│ рЅђрѕѕрѕЮ
­ЪЉІ	ріЦрїЁ рѕЏрІѕрІЏрІѕрІЮ
­ЪЉІ­ЪЈ╗	ріЦрїЁ рЅарѕЏрІЇрѕѕрЅЦрѕѕрЅЦрЇА рЅђрѕІрѕЇ рІерЅєрІ│ рЅђрѕѕрѕЮ
­ЪЉІ­ЪЈ╝	ріЦрїЁ рЅарѕЏрІЇрѕѕрЅЦрѕѕрЅЦрЇА рѕўрѕЃріерѕѕріЏ рЅђрѕІ рІФрѕѕ рІерЅєрІ│ рЅђрѕѕрѕЮ
­ЪЉІ­ЪЈй	ріЦрїЁ рѕЏрІѕрІЏрІѕрІЮрЇА рѕўрѕЃріерѕѕріЏ рІерЅєрІ│ рЅђрѕѕрѕЮ
­ЪЉІ­ЪЈЙ	ріЦрїЁ рЅарѕЏрІЇрѕѕрЅЦрѕѕрЅЦрЇА рѕўрѕЃріерѕѕріЏ рЅђрѕІ рІФрѕѕ рІерЅєрІ│ рЅђрѕѕрѕЮ
­ЪЉІ­ЪЈ┐	ріЦрїЁ рЅарѕЏрІЇрѕѕрЅЦрѕѕрЅЦ: рїЦрЅЂрѕГ рІерЅєрІ│ рЅђрѕѕрѕЮ
­ЪцЪ	рЇЇрЅЁрѕГ - рІеріЦрїЁ рѕЮрѕЇріГрЅх
­ЪцЪ­ЪЈ╗	рІерЇЇрЅЁрѕГ рѕЮрѕЇріГрЅхрЇА рЅђрѕІрѕЇ рІерЅєрІ│ рЅђрѕѕрѕЮ
­ЪцЪ­ЪЈ╝	рІерЇЇрЅЁрѕГ рѕЮрѕЇріГрЅхрЇА рѕўрѕЃріерѕѕріЏ рЅђрѕІ рІФрѕѕ рІерЅєрІ│ рЅђрѕѕрѕЮ
­ЪцЪ­ЪЈй	рІерЇЇрЅЁрѕГ рѕЮрѕЇріГрЅхрЇА рѕўрѕЃріерѕѕріЏ рІерЅєрІ│ рЅђрѕѕрѕЮ
­ЪцЪ­ЪЈЙ	рІерЇЇрЅЁрѕГ рѕЮрѕЇріГрЅхрЇА рѕўрѕЃріерѕѕріЏ рЅђрѕІ рІФрѕѕ рІерЅєрІ│ рЅђрѕѕрѕЮ
­ЪцЪ­ЪЈ┐	рЇЇрЅЁрѕГ-ріаріЋрЅ░ рѕЮрѕЇріГрЅх: рїЦрЅЂрѕГ рІерЅєрІ│ рЅђрѕѕрѕЮ
РюЇ№ИЈ	ріЦрїЁ рѕўрї╗рЇЇ
РюЇ	ріЦрїЁ рѕўрї╗рЇЇ
РюЇ­ЪЈ╗	рІеріЦрїЁ рїйрѕЉрЇЇ: рЅђрѕІрѕЇ рІерЅєрІ│ рЅђрѕѕрѕЮ
РюЇ­ЪЈ╝	рІеріЦрїЁ рїйрѕЉрЇЇ: рѕўрѕЃріерѕѕріЏ рЅђрѕІ рІФрѕѕ рІерЅєрІ│ рЅђрѕѕрѕЮ
РюЇ­ЪЈй	рІеріЦрїЁ рїйрѕЉрЇЇ: рѕўрѕЃріерѕѕріЏ рІерЅєрІ│ рЅђрѕѕрѕЮ
РюЇ­ЪЈЙ	рІеріЦрїЁ рїйрѕЉрЇЇ: рѕўрѕЃріерѕѕріЏ-рїЦрЅЂрѕГ рІерЅєрІ│ рЅђрѕѕрѕЮ
РюЇ­ЪЈ┐	рІеріЦрїЁ рїйрѕЉрЇЇ: рїЦрЅЂрѕГ рІерЅєрІ│ рЅђрѕѕрѕЮ
­ЪЉЈ	рѕЏрїерЅЦрїерЅЦ
­ЪЉЈ­ЪЈ╗	рѕЏрїерЅЦрїерЅЦрЇА рЅђрѕІрѕЇ рІерЅєрІ│ рЅђрѕѕрѕЮ
­ЪЉЈ­ЪЈ╝	рѕЏрїерЅЦрїерЅЦрЇА рѕўрѕЃріерѕѕріЏ рЅђрѕІ рІФрѕѕ рІерЅєрІ│ рЅђрѕѕрѕЮ
­ЪЉЈ­ЪЈй	рѕЏрїерЅЦрїерЅЦ: рѕўрѕЃріерѕѕріЏ рІерЅєрІ│ рЅђрѕѕрѕЮ
­ЪЉЈ­ЪЈЙ	рѕЏрїерЅЦрїерЅЦрЇА рѕўрѕЃріерѕѕріЏ рЅђрѕІ рІФрѕѕ рІерЅєрІ│ рЅђрѕѕрѕЮ
­ЪЉЈ­ЪЈ┐	рѕЏрїерЅЦрїерЅЦ: рїЦрЅЂрѕГ рІерЅєрІ│ рЅђрѕѕрѕЮ
­ЪЉљ	ріГрЇЇрЅх ріЦрїєрЅй
­ЪЉљ­ЪЈ╗	ріГрЇЇрЅх ріЦрїєрЅй: рЅђрѕІрѕЇ рІерЅєрІ│ рЅђрѕѕрѕЮ
­ЪЉљ­ЪЈ╝	ріГрЇЇрЅх ріЦрїєрЅй: рѕўрѕЃріерѕѕріЏ рЅђрѕІ рІФрѕѕ рІерЅєрІ│ рЅђрѕѕрѕЮ
­ЪЉљ­ЪЈй	ріГрЇЇрЅх ріЦрїєрЅй: рѕўрѕЃріерѕѕріЏ рІерЅєрІ│ рЅђрѕѕрѕЮ
­ЪЉљ­ЪЈЙ	ріГрЇЇрЅх ріЦрїєрЅй: рѕўрѕЃріерѕѕріЏ-рїЦрЅЂрѕГ рІерЅєрІ│ рЅђрѕѕрѕЮ
­ЪЉљ­ЪЈ┐	ріГрЇЇрЅх ріЦрїєрЅй: рїЦрЅЂрѕГ рІерЅєрІ│ рЅђрѕѕрѕЮ
­ЪЎї	ріЦрїєрЅйріЋ рѕЏріЋрѕ│рЅх
­ЪЎї­ЪЈ╗	ріЦрїєрЅйріЋ рѕЏріЋрѕ│рЅх: рЅђрѕІрѕЇ рІерЅєрІ│ рЅђрѕѕрѕЮ
­ЪЎї­ЪЈ╝	ріЦрїєрЅйріЋ рѕЏріЋрѕ│рЅх: рѕўрѕЃріерѕѕріЏ рЅђрѕІ рІФрѕѕ рІерЅєрІ│ рЅђрѕѕрѕЮ
­ЪЎї­ЪЈй	ріЦрїєрЅйріЋ рѕЏріЋрѕ│рЅх: рѕўрѕЃріерѕѕріЏ рІерЅєрІ│ рЅђрѕѕрѕЮ
­ЪЎї­ЪЈЙ	ріЦрїєрЅйріЋ рѕЏріЋрѕ│рЅх: рѕўрѕЃріерѕѕріЏ-рїЦрЅЂрѕГ рІерЅєрІ│ рЅђрѕѕрѕЮ
­ЪЎї­ЪЈ┐	ріЦрїєрЅйріЋ рѕЏріЋрѕ│рЅх: рїЦрЅЂрѕГ рІерЅєрІ│ рЅђрѕѕрѕЮ
­Ъц▓	рЅаріаріЋрІхріљрЅх рѕўрІ│рЇЇ
­Ъц▓­ЪЈ╗	рѕўрІ│рЇЇ ріаріЋрІх рѕІрІГрЇА рЅђрѕІрѕЇ рІерЅєрІ│ рЅђрѕѕрѕЮ
­Ъц▓­ЪЈ╝	рѕўрІ│рЇЇ ріаріЋрІх рѕІрІГрЇА рѕўрѕЃріерѕѕріЏ рЅђрѕІ рІФрѕѕ рІерЅєрІ│ рЅђрѕѕрѕЮ
­Ъц▓­ЪЈй	рѕўрІ│рЇЇ ріаріЋрІх рѕІрІГрЇА рѕўрѕЃріерѕѕріЏ рІерЅєрІ│ рЅђрѕѕрѕЮ
­Ъц▓­ЪЈЙ	рѕўрІ│рЇЇ ріаріЋрІх рѕІрІГрЇА рѕўрѕЃріерѕѕріЏ рЅђрѕІ рІФрѕѕ рІерЅєрІ│ рЅђрѕѕрѕЮ
­Ъц▓­ЪЈ┐	рѕўрІ│рЇЇ ріаріЋрІх рѕІрІГ: рїЦрЅЂрѕГ рІерЅєрІ│ рЅђрѕѕрѕЮ
­ЪЎЈ	рІерЅ│рїарЇѕ ріЦрїєрЅй
­ЪЎЈ­ЪЈ╗	рІерЅ│рїарЇѕ ріЦрїєрЅй: рЅђрѕІрѕЇ рІерЅєрІ│ рЅђрѕѕрѕЮ
­ЪЎЈ­ЪЈ╝	рІерЅ│рїарЇѕ ріЦрїєрЅйрЇА рѕўрѕЃріерѕѕріЏ рЅђрѕІ рІФрѕѕ рІерЅєрІ│ рЅђрѕѕрѕЮ
­ЪЎЈ­ЪЈй	рІерЅ│рїарЇѕ ріЦрїєрЅй: рѕўрѕЃріерѕѕріЏ рІерЅєрІ│ рЅђрѕѕрѕЮ
­ЪЎЈ­ЪЈЙ	рІерЅ│рїарЇѕ ріЦрїєрЅй: рѕўрѕЃріерѕѕріЏ-рїЦрЅЂрѕГ рІерЅєрІ│ рЅђрѕѕрѕЮ
­ЪЎЈ­ЪЈ┐	рІерЅ│рїарЇѕ ріЦрїєрЅй: рїЦрЅЂрѕГ рІерЅєрІ│ рЅђрѕѕрѕЮ
­ЪцЮ	рѕўрїерЅБрЅарїЦ
­ЪњЁ	рІерїЦрЇЇрѕГ рЅђрѕѕрѕЮ
­ЪњЁ­ЪЈ╗	рІерїЦрЇЇрѕГ рЅђрѕѕрѕЮ: рЅђрѕІрѕЇ рІерЅєрІ│ рЅђрѕѕрѕЮ
­ЪњЁ­ЪЈ╝	рІерїЦрЇЇрѕГ рЅђрѕѕрѕЮрЇА рѕўрѕЃріерѕѕріЏ рЅђрѕІ рІФрѕѕ рІерЅєрІ│ рЅђрѕѕрѕЮ
­ЪњЁ­ЪЈй	рІерїЦрЇЇрѕГ рЅђрѕѕрѕЮ: рѕўрѕЃріерѕѕріЏ рІерЅєрІ│ рЅђрѕѕрѕЮ
­ЪњЁ­ЪЈЙ	рІерїЦрЇЇрѕГ рЅђрѕѕрѕЮ: рѕўрѕЃріерѕѕріЏ-рїЦрЅЂрѕГ рІерЅєрІ│ рЅђрѕѕрѕЮ
­ЪњЁ­ЪЈ┐	рІерїЦрЇЇрѕГ рЅђрѕѕрѕЮ: рїЦрЅЂрѕГ рІерЅєрІ│ рЅђрѕѕрѕЮ
­ЪЉѓ	рїєрѕ«
­ЪЉѓ­ЪЈ╗	рїєрѕ«: рЅђрѕІрѕЇ рІерЅєрІ│ рЅђрѕѕрѕЮ
­ЪЉѓ­ЪЈ╝	рїєрѕ«: рѕўрѕЃріерѕѕріЏ рЅђрѕІ рІФрѕѕ рІерЅєрІ│ рЅђрѕѕрѕЮ
­ЪЉѓ­ЪЈй	рїєрѕ«: рѕўрѕЃріерѕѕріЏ рІерЅєрІ│ рЅђрѕѕрѕЮ
­ЪЉѓ­ЪЈЙ	рїєрѕ«: рѕўрѕЃріерѕѕріЏ-рїЦрЅЂрѕГ рІерЅєрІ│ рЅђрѕѕрѕЮ
­ЪЉѓ­ЪЈ┐	рїєрѕ«: рїЦрЅЂрѕГ рІерЅєрІ│ рЅђрѕѕрѕЮ
­ЪЉЃ	ріарЇЇріЋрїФ
­ЪЉЃ­ЪЈ╗	ріарЇЇріЋрїФ: рЅђрѕІрѕЇ рІерЅєрІ│ рЅђрѕѕрѕЮ
­ЪЉЃ­ЪЈ╝	ріарЇЇріЋрїФ: рѕўрѕЃріерѕѕріЏ рЅђрѕІ рІФрѕѕ рІерЅєрІ│ рЅђрѕѕрѕЮ
­ЪЉЃ­ЪЈй	ріарЇЇріЋрїФ: рѕўрѕЃріерѕѕріЏ рІерЅєрІ│ рЅђрѕѕрѕЮ
­ЪЉЃ­ЪЈЙ	ріарЇЇріЋрїФ: рѕўрѕЃріерѕѕріЏ-рїЦрЅЂрѕГ рІерЅєрІ│ рЅђрѕѕрѕЮ
­ЪЉЃ­ЪЈ┐	ріарЇЇріЋрїФ: рїЦрЅЂрѕГ рІерЅєрІ│ рЅђрѕѕрѕЮ
­Ъд░	рЅђрІГ-рїИрїЅрѕГ
­Ъд▒	ріЕрѕГрЅБ-рїИрїЅрѕГ
­Ъд▓	рѕФрѕ░ рЅарѕФ
­Ъд│	ріљрїГ-рїИрїЅрѕГ
­ЪЉБ	ріарѕ╗рѕФрІјрЅй
­ЪЉђ	ріарІГріќрЅй
­ЪЉЂ№ИЈ	рІЊрІГріЋ
­ЪЉЂ	рІЊрІГріЋ
­ЪЉЂ№ИЈРђЇ­ЪЌе№ИЈ	рЅаріЋрїЇрїЇрѕГ ріарѕерЇІ рІЇрѕхрїЦ рІЊрІГріЋ
­ЪЉЂРђЇ­ЪЌе№ИЈ	рЅаріЋрїЇрїЇрѕГ ріарѕерЇІ рІЇрѕхрїЦ рІЊрІГріЋ
­ЪЉЂ№ИЈРђЇ­ЪЌе	рЅаріЋрїЇрїЇрѕГ ріарѕерЇІ рІЇрѕхрїЦ рІЊрІГріЋ
­ЪЉЂРђЇ­ЪЌе	рЅаріЋрїЇрїЇрѕГ ріарѕерЇІ рІЇрѕхрїЦ рІЊрІГріЋ
­ЪДа	ріаріЋрїјрѕЇ
­Ъд┤	ріарїЦріЋрЅх
­Ъди	рїЦрѕГрѕх
­ЪЉЁ	ріаріЋрІ░рЅарЅх
­ЪЉё	ріарЇЇ
­ЪњІ	рІерѕўрѕ│рѕЮ рѕЮрѕЇріГрЅх
­Ъњў	рЅђрѕхрЅх рІФрѕѕрІЇ рѕЇрЅЦ
РЮц№ИЈ	рЅђрІГ рѕЇрЅЦ
РЮц	рЅђрІГ рѕЇрЅЦ
­ЪњЊ	рІерѕЇрЅЦ рѕўрѕЮрЅ│рЅх
­Ъњћ	рІерЅ░рѕ░рЅарѕе рѕЇрЅЦ
­ЪњЋ	рѕЂрѕѕрЅх рѕЇрЅдрЅй
­Ъњќ	рІерѕџрІФрЅЦрѕѕрїерѕЇрїГ рѕЇрЅЦ
­ЪњЌ	ріЦрІФрІ░рїѕ рѕЇрЅЦ
­ЪњЎ	рѕ░рѕЏрІФрІі рѕЇрЅЦ
­Ъњџ	ріарѕеріЋрїЊрІ┤ рѕЇрЅЦ
­ЪњЏ	рЅбрїФ рѕЇрЅЦ
­ЪДА	рЅЦрѕГрЅ▒ріФріЋ рѕЇрЅЦ
­Ъњю	рѕљрѕЮрѕФрІі рѕЇрЅЦ
­Ъќц	рїЦрЅЂрѕГ рѕЇрЅЦ
­ЪњЮ	рѕЇрЅЦ ріерѕфрЅБріЋ рїІрѕГ
­Ъњъ	рЅ░рІўрІІрІІрѕф рѕЇрЅдрЅй
­ЪњЪ	рІерѕЇрЅЦ рѕЏрѕхрїїрїЦ
РЮБ№ИЈ	ріерЅБрІх рІерѕЇрЅЦ рїЕріИрЅх
РЮБ	ріерЅБрІх рІерѕЇрЅЦ рїЕріИрЅх
­Ъњї	рІерЇЇрЅЁрѕГ рІ░рЅЦрІ│рЅц
­Ъњц	zzz
­Ъњб	рІерЅЂрїБ рѕЮрѕЇріГрЅх
­ЪњБ	рЅдрѕЮрЅЦ
­ЪњЦ	рїЇрїГрЅх
­Ъњд	рѕІрЅЦ ріљрїарЅЦрїБрЅдрЅй
­Ъње	ріЦрІерІ░рЅарІ░рЅа
­ЪњФ	рѕўрЇЇрІўрІЮ
­Ъњг	рІеріЋрїЇрїЇрѕГ рЇіріЏ
­ЪЌе№ИЈ	рІерїЇрѕФ рІеріЋрїЇрїЇрѕГ ріарѕерЇІ
­ЪЌе	рІерїЇрѕФ рІеріЋрїЇрїЇрѕГ ріарѕерЇІ
­ЪЌ»№ИЈ	рЅхріГріГрѕѕріЏ рЅЂрїБ ріарѕерЇІ
­ЪЌ»	рЅхріГріГрѕѕріЏ рЅЂрїБ ріарѕерЇІ
­ЪњГ	ріарѕ░рЅЦріЕ рЇіріЏ
­ЪЋ│№ИЈ	рЅђрІ│рІ│
­ЪЋ│	рЅђрІ│рІ│
­ЪЉЊ	рѕўріљрїйрѕГ
­ЪЋХ№ИЈ	рІерЇђрѕљрІГ рѕўріљрЇЁрѕГ
­ЪЋХ	рІерЇђрѕљрІГ рѕўріљрЇЁрѕГ
­ЪЦй	рѕўріљрїйрѕГ
­ЪЦ╝	рІерѕІрЅЦрѕФрЅХрѕф рЅђрѕџрѕх
­ЪЉћ	ріГрѕФрЅБрЅх
­ЪЉЋ	рЅ▓рѕИрѕГрЅх
­ЪЉќ	рїѓріЋрѕх
­ЪДБ	рѕўрѕђрѕерЅЦ
­ЪДц	рїЊріЋрЅх
­ЪДЦ	рі«рЅх
­ЪДд	ріФрѕЇрѕ▓рІјрЅй
­ЪЉЌ	ріарѕѕрЅБрЅарѕх
­ЪЉў	ріфрѕъріќ
­ЪЉЎ	рЅбріфріњ
­ЪЉџ	рІерѕ┤рЅх рѕЇрЅЦрѕХрЅй
­ЪЉЏ	рЅдрѕГрѕ│
­ЪЉю	рІеріЦрїЁ рЅдрѕГрѕ│
­ЪЉЮ	ріГрѕІрЅй рЅдрѕГрѕ│
­ЪЏЇ№ИЈ	рІерїЇрІб рЅдрѕГрѕ│рІјрЅй
­ЪЏЇ	рІерїЇрІб рЅдрѕГрѕ│рІјрЅй
­Ъјњ	рІерЅхрѕЮрѕЁрѕГрЅх рЅцрЅх рЅдрѕГрѕ│
­ЪЉъ	рІерѕ░рІЇ рїФрѕЏ
­ЪЉЪ	рІерѕЕрїФ рїФрѕЏ
­ЪЦЙ	рІеріЦрїЇрѕГ рїЅрІъ рЅдрЅх
­ЪЦ┐	рІерѕ┤рЅх рїарЇЇрїБрЇІ рїФрѕЏ
­ЪЉа	рЅБрѕѕріерЇЇрЅ░ріЏ рїФрѕЏ рїФрѕЏ
­ЪЉА	рІерѕ┤рЅх рїФрѕЏ рїФрѕЏ
­ЪЉб	рІерѕ┤рЅх рЅдрЅх рїФрѕЏ
­ЪЉЉ	ріаріГрѕірѕЇ
­ЪЉњ	рІерѕ┤рЅх рі«рЇЇрІФ
­ЪјЕ	рі«рЇЇрІФ
­ЪјЊ	рІерѕЮрѕерЅЃ ріФрЇЋ
­ЪДб	рІерЅ░ріерЇѕрѕѕ ріФрЇЋ
РЏЉ№ИЈ	рІеріљрЇЇрѕх ріарІхріЋ рѕ░рѕФрЅ░ріЏ рІерѕФрѕх рЅЂрѕГ
РЏЉ	рІеріљрЇЇрѕх ріарІхріЋ рѕ░рѕФрЅ░ріЏ рІерѕФрѕх рЅЂрѕГ
­ЪЊ┐	рІерїИрѕјрЅх рІХрЅЃрІјрЅй
­Ъњё	рѕірЇЋрѕхрЅ▓ріГ
­ЪњЇ	рЅђрѕѕрЅарЅх
­Ъњј	рІеріерЅарѕе рІхріЋрїІрІГ
­Ъљх	рІерІЮріЋрїђрѕ« рЇірЅх
­Ъљњ	рїдрїБ
­ЪдЇ	рїјрѕфрѕІ
­ЪљХ	рІерІЇрѕ╗ рЇірЅх
­ЪљЋ	рІЇрѕ╗
­ЪљЕ	рЇЉрІхрѕЇ
­Ъљ║	рЅ░ріЕрѕІ рЇірЅх
­Ъді	рІерЅђрЅарѕ« рЇірЅх
­ЪдЮ	рѕФрі«ріЋ
­Ъљ▒	рІерІхрѕўрЅх рЇірЅх
­Ъљѕ	рІхрѕўрЅх
­ЪдЂ	ріаріЋрЅарѕ│ рЇірЅх
­Ъљ»	рІеріљрЅЦрѕГ рЇірЅх
­ЪљЁ	ріљрЅЦрѕГ
­Ъљє	ріљрЅЦрѕГ
­Ъљ┤	рІерЇѕрѕерѕх рЇірЅх
­Ъљј	рЇѕрѕерѕх
­Ъдё	рІЕріњрі«рѕГріЋ рЇірЅх
­ЪдЊ	рІерѕюрІ│ ріарѕЁрІФ
­Ъдї	ріарїІрІўріЋ
­Ъљ«	рѕІрѕЮ рЇірЅх
­Ъљѓ	рЅарѕг
­ЪљЃ	рІерІЇрѕЃ рїјрѕй
­Ъљё	рѕІрѕЮ
­Ъљи	рІеріарѕ│рѕЏ рЇірЅх
­Ъљќ	ріарѕ│рѕЏ
­ЪљЌ	ріерѕГріерѕ«
­Ъљй	рІеріарѕ│рѕЏ ріарЇЇріЋрїФ
­ЪљЈ	рѕФріЋрІ░рѕЮ ріаріГрѕ░рѕх рѕюрѕърѕф
­ЪљЉ	рЅарїЇ
­Ъљљ	рЇЇрІерѕЇ
­Ъљф	рїЇрѕўрѕЇ
­ЪљФ	рѕЂрѕѕрЅх рїЅрЅЦрЅ│ рїЇрѕўрѕЇ
­ЪдЎ	рѕІрѕЏ
­Ъдњ	рЅђрїГріћ
­Ъљў	рІЮрѕєріЋ
­ЪдЈ	ріарІЇрѕФрѕфрѕх
­ЪдЏ	рїЅрѕЏрѕг
­ЪљГ	рІерѕўрІ│рЇірЅх рЇірЅх
­ЪљЂ	ріарІГрїЦ
­Ъљђ	ріарІГрїЦ
­Ъљ╣	рІерѕЃрѕЮрѕхрЅ░рѕГ рЇірЅх
­Ъљ░	рїЦріЋрЅИрѕЇ рЇірЅх
­ЪљЄ	рїЦріЋрЅИрѕЇ
­Ъљ┐№ИЈ	рЅ║рЇЋрѕЏріЋріГ
­Ъљ┐	рЅ║рЇЋрѕЏріЋріГ
­Ъдћ	рїЃрѕГрЅх
­ЪдЄ	рІерѕїрѕірЅх рІѕрЇЇ
­Ъљ╗	рІхрЅЦ рЇірЅх
­Ъље	рі«рІІрѕІ
­Ъљ╝	рІерЇЊріЋрІ│ рЇірЅх
­Ъдў	ріФріЋрїІрѕ«
­ЪдА	рЅБрїЁ
­ЪљЙ	рІеріЦрїЇрѕГ рѕЁрЅхрѕўрЅХрЅй
­ЪдЃ	рЅ▒рѕфріГ
­Ъљћ	рІХрѕ«
­ЪљЊ	рІХрѕ«
­ЪљБ	рІерѕџрЇѕрѕЇрЅЁ рїФрїЕрЅх
­Ъљц	рѕЋрЇЃріЋ рїФрїЕрЅх
­ЪљЦ	рЇірЅх рѕѕрЇірЅх рІФрѕѕрІЇ рѕЁрЇЃріЋ рїФрїЕрЅх
­Ъљд	рІѕрЇЇ
­ЪљД	рЇћріЋрїЇрІіріЋ
­ЪЋі№ИЈ	ріЦрѕГрїЇрЅЦ
­ЪЋі	ріЦрѕГрїЇрЅЦ
­ЪдЁ	ріЋрѕхрѕГ
­Ъдє	рІ│ріГрІг
­Ъдб	рѕхрІІріЋ
­ЪдЅ	рїЅрїЅрЅхрЇб
­Ъдџ	рЇњрі«ріГ
­Ъдю	рЅарЅђрЅђріЋ
­ЪљИ	рІеріЦріЋрЅЂрѕФрѕфрЅх рЇірЅх
­Ъљі	ріарІъ
­Ъљб	ріцрѕі
­Ъдј	ріЦріЋрѕйрѕІрѕірЅх
­ЪљЇ	ріЦрЅБрЅЦ
­Ъљ▓	рІўріЋрІХ рЇірЅх
­ЪљЅ	рІўріЋрІХ
­ЪдЋ	рѕ│рѕ«рЇќрІх
­Ъдќ	рЅ▓-рѕгріГрѕх
­Ъљ│	spouting whale
­ЪљІ	рІЊрѕБ ріљрЅБрѕф
­Ъљг	рІХрѕЇрЇіріЋ
­ЪљЪ	ріарѕ│
­Ъља	рѕърЅЃрЅ│рѕЏ рІЊрѕБ
­ЪљА	рЅЦрЇЅрЇірѕй
­Ъдѕ	рѕ╗рѕГріГ
­ЪљЎ	рідріГрЅХрЇљрѕх
­Ъљџ	рїарѕўрІЮрѕЏрІЏ рЅЁрѕГрЇірЅх
­Ъдђ	рѕИрѕГрїБріЋ
­Ъдъ	рѕјрЅЦрѕхрЅ░рѕГ
­Ъдљ	рѕйрѕфрѕЮрЇЋ
­ЪдЉ	рѕхріЕрІірІх
­Ъљї	рЅђріЋрІх ріарІЇрїБ
­ЪдІ	рЅбрѕФрЅбрѕ«
­ЪљЏ	рѕ│ріЋріФ
­Ъљю	рїЅріЋрІ│ріЋ
­ЪљЮ	рІерѕЏрѕГ ріЋрЅЦ
­Ъљъ	ріЦрѕўрЅцрЅх рїЦріЋрІџрІЏ
­ЪдЌ	ріГрѕфрігрЅх
­ЪЋи№ИЈ	рѕИрѕерѕфрЅх
­ЪЋи	рѕИрѕерѕфрЅх
­ЪЋИ№ИЈ	рѕИрѕерѕфрЅх рІхрѕГ
­ЪЋИ	рѕИрѕерѕфрЅх рІхрѕГ
­Ъдѓ	рїіріЋрїЦ
­ЪдЪ	рЅхріЋріЮ
­Ъда	рѕЏрІГріГрѕ«рЅдрЅй
­Ъњљ	ріЦрЅЁрЇЇ ріарЅарЅБ
­ЪїИ	рІерЅ╝рѕф ріарЅарЅБ
­Ъњ«	ріљрїГ ріарЅарЅБ
­ЪЈх№ИЈ	рѕ«рІЮрЅ┤
­ЪЈх	рѕ«рІЮрЅ┤
­Ъї╣	рЅ░ріљрѕ│
­ЪЦђ	рІерІ░рѕерЅђ ріарЅарЅБ
­Ъї║	рѕѓрЅбрѕхріерѕх
­Ъї╗	рІерѕ▒рЇЇ ріарЅарЅБ
­Ъї╝	ріарЅарЅа
­Ъїи	рЅ▒рѕірЇЋ
­Ъї▒	рЅйрїЇріЮ
­Ъї▓	рІерѕЏрІГрѕерїЇрЇЇ рІЏрЇЇ
­Ъї│	рІерѕџрѕерїЇрЇЇ рІЏрЇЇ
­Ъї┤	рІерІўріЋрЅБрЅБ рІЏрЇЇ
­Ъїх	рЅЂрѕЇрЅІрѕЇ
­ЪїЙ	рІерѕЕрІЮ ріљрІХ
­Ъї┐	рІЋрЇЁрІІрЅх
Рўў№ИЈ	shamrock
Рўў	shamrock
­ЪЇђ	ріарѕФрЅх рЅЁрїарѕЇ
­ЪЇЂ	рІерѕЏрЇЋрѕЇ рЅЁрїарѕЇ
­ЪЇѓ	рІерІѕрІ░рЅђ рЅЁрїарѕЇ
­ЪЇЃ	рЅаріљрЇІрѕх рІерѕџрІѕрІЏрІѕрІЮ рЅЁрїарѕЇ
­ЪЇЄ	рІѕрІГріЋ
­ЪЇѕ	рѕљрЅЦрѕљрЅЦ
­ЪЇЅ	рѕљрЅЦрѕљрЅЦ
­ЪЇі	рѕўріЋрІ░рѕфріЋ
­ЪЇІ	рѕјрѕџ
­ЪЇї	рѕЎрІЮ
­ЪЇЇ	ріаріЊріЊрѕх
­ЪЦГ	рѕЏріЋрїј
­ЪЇј	рЅђрІГ рЇќрѕЮ
­ЪЇЈ	ріарѕеріЋрїЊрІ┤ рЇќрѕЮ
­ЪЇљ	рІЋріЋрЅЂ
­ЪЇЉ	рі«ріГ
­ЪЇњ	рЅ╝рѕф
­ЪЇЊ	ріЦріЋрїєрѕф
­ЪЦЮ	рІеріфрІі рЇЇрѕг
­ЪЇЁ	рЅ▓рѕЏрЅ▓рѕЮ
­ЪЦЦ	рі«рі«ріЊрЅх
­ЪЦЉ	ріарЅ«ріФрІХ
­ЪЇє	ріцрїЇрЇЋрѕІріЋрЅх
­ЪЦћ	рІхріЋрЅй
­ЪЦЋ	ріФрѕ«рЅх
­Ъїй	рІерЅарЅєрѕј рїєрѕ«
­ЪїХ№ИЈ	рЅхріЕрѕх рЅарѕГрЅарѕг
­ЪїХ	рЅхріЕрѕх рЅарѕГрЅарѕг
­ЪЦњ	рІ▒рЅБ
­ЪЦг	рЅЁрїарѕІрѕЏ ріарѕеріЋрїЊрІ┤
­ЪЦд	рЅЦрѕ«рі«рѕі
­ЪЇё	ріЦріЋрїЅрІ│рІГ
­ЪЦю	рідрЅЙрѕјріњ
­Ъї░	рІ░рѕерЅхріЋ
­ЪЇъ	рІ│рЅд
­ЪЦљ	ріГрѕЕрѕ┤ріЋрЅх
­ЪЦќ	рІе baguette рІ│рЅд
­ЪЦе	рЇЋрѕфрІЮрѕЇ
­ЪЦ»	рЅдрѕГрѕ│
­ЪЦъ	рЇЊріЋрігрі«рЅй
­ЪДђ	рІерЅ║рІЮ рЅЂрѕФрїГ
­ЪЇќ	рѕхрїІ рЅаріарїЦріЋрЅх рѕІрІГ
­ЪЇЌ	рІерІХрѕ« ріЦрѕГрЅБрЅ│ ріЦрїЇрѕГ
­ЪЦЕ	рѕхрїІ рѕўрЅЂрѕерїЦ
­ЪЦЊ	рЅцріеріЋ
­ЪЇћ	рѕђрѕЮрЅарѕГрїѕрѕГ
­ЪЇЪ	рЅБрѕѕрїБрЅх рІерІхріЋрЅй рїЦрЅЦрѕх
­ЪЇЋ	рЇњрІЏ
­ЪїГ	рѕєрЅх рІХрїЇ
­ЪЦф	рѕ│ріЋрІхрІірЅй
­Ъї«	рЅ│рі«
­Ъї»	рЅАрѕфрЅХ
­ЪЦЎ	рІерЅ░рѕърѕІ рїарЇЇрїБрЇІ рІ│рЅд
­ЪЦџ	ріЦріЋрЅЂрѕІрѕЇ
­ЪЇ│	рѕЮрїЇрЅЦ рѕЏрЅЦрѕ░рѕЇ
­ЪЦў	рїЦрѕЇрЅђрЅх рІерѕїрѕѕрІЇ рѕЮрїЇрЅЦ
­ЪЇ▓	рІерѕЮрїЇрЅЦ рѕЏрѕ░рѕ«
­ЪЦБ	рїјрІхрїЊрІ│ рѕ│рѕЁріЋ рЅарѕЏріЋріфрІФ
­ЪЦЌ	ріарѕеріЋрїЊрІ┤ рѕ░рѕІрїБ
­ЪЇ┐	рЇІріЋрІ▓рѕ╗
­ЪДѓ	рїерІЇ
­ЪЦФ	рІерЅ│рѕИрїѕ рѕЮрїЇрЅЦ
­ЪЇ▒	рЅцріЋрЅХ рѕ│рїЦріЋ
­ЪЇў	рІерѕЕрІЮ рЅЦрѕхріЕрЅх
­ЪЇЎ	рІерѕЕрІЮ рі│рѕх
­ЪЇџ	рІерЅарѕ░рѕѕ рѕЕрІЮ
­ЪЇЏ	ріФрѕф рѕЕрІЮ
­ЪЇю	рІеріЦріЋрЇІрѕјрЅх рїјрІхрїЊрІ│ рѕ│рѕЁріЋ
­ЪЇЮ	рѕхрЇЊрїїрЅ▓
­ЪЇа	рІерЅ░рїарЅарѕ░ рїБрЇІрїГ рІхріЋрЅй
­ЪЇб	рідрІ░ріЋ
­ЪЇБ	рѕ▒рѕ║
­ЪЇц	рІерЅ░рїарЅарѕ░ рѕйрѕфрѕЮрЇЋ
­ЪЇЦ	рІерІЊрѕ│ рігріГ ріерѕйріГрѕГріГрѕфрЅх рїІрѕГ
­ЪЦ«	рІерїерѕерЅЃ рігріГ
­ЪЇА	рІ│ріЋрїј
­ЪЦЪ	рІ▒рЇЋрѕіріЋрїЇ
­ЪЦа	рѕђрЅЦрЅх ріЕріф
­ЪЦА	рІерѕўрІЇрѕ░рїЃ рѕ│рїЦріЋ
­ЪЇд	рѕѕрѕхрѕІрѕ│ ріарІГрѕхріГрѕгрѕЮ
­ЪЇД	рІерЅ░рѕІрїе рЅарѕерІХ
­ЪЇе	ріарІГрѕх ріГрѕГрѕЮ
­ЪЇЕ	рІХріЊрЅх
­ЪЇф	ріЕріф
­Ъјѓ	рІерѕЇрІ░рЅх рігріГ
­ЪЇ░	ріарїГрѕГ рігріГ
­ЪДЂ	ріЕрЅБрІФ рігріГ
­ЪЦД	ріарѕЮрЅБрѕ╗
­ЪЇФ	рЅИрі«рѕїрЅх рЅБрѕГ
­ЪЇг	ріерѕерѕюрѕІ
­ЪЇГ	рѕјрѕірЇќрЇЋ
­ЪЇ«	ріЕрѕхрЅ│рѕГрІх
­ЪЇ»	рІерѕЏрѕГ рѕЏрѕ░рѕ«
­ЪЇ╝	рІерѕЋрЇЃріЋ рїарѕГрѕЎрѕх
­ЪЦЏ	рЅЦрѕГрїГрЅє рІѕрЅ░рЅх
РўЋ	рЅхріЕрѕх рѕўрїарїЦ
­ЪЇх	рІерѕ╗рІГ рѕЏріЋріфрІФ рІФрѕѕ ріЦрїђрЅ│
­ЪЇХ	рѕЮріГріЋрІФрЅх
­ЪЇЙ	рЅАрѕй рЅЦрЅЁ рІФрѕѕ рїарѕГрѕЎрѕх
­ЪЇи	рІерІѕрІГріЋ рЅЦрѕГрїГрЅє
­ЪЇИ	рі«ріГрЅ┤рѕЇ рЅЦрѕГрїГрЅє
­ЪЇ╣	рѕърЅЃрЅ│рѕЏ рѕўрїарїЦ
­ЪЇ║	рІерЅбрѕФ ріЕрЅБрІФ
­ЪЇ╗	рІерЅбрѕФ рѕЏрѕ░рѕ«рІјрЅй
­ЪЦѓ	рІерѕџрІФрїерЅарїГрЅА рЅЦрѕГрїГрЅєрІјрЅй
­ЪЦЃ	tumbler рѕўрѕхрЅ│рІѕрЅх
­ЪЦц	ріЕрЅБрІФ ріерїѕрѕѕрЅБ рїІрѕГ
­ЪЦб	рЅЙрЇЋрѕхрЅ▓ріГрѕх
­ЪЇй№ИЈ	рѕ╣ріФ ріЦріЊ рЅбрѕІрІІ рЅарїарЇЇрїБрЇІ
­ЪЇй	рѕ╣ріФ ріЦріЊ рЅбрѕІрІІ рЅарїарЇЇрїБрЇІ
­ЪЇ┤	рѕ╣ріФ ріЦріЊ рЅбрѕІрІІ
­ЪЦё	рѕЏріЋріфрІФ
­Ъћф	рІерІѕрїЦ рЅцрЅх рЅбрѕІрІІ
­ЪЈ║	ріарѕЮрЇќрѕФ
­ЪїЇ	рѕЅрѕЇ ріарІЇрѕ«рЇЊ-ріарЇЇрѕфріФріЋ рІФрѕ│рІФрѕЇ
­Ъїј	рѕЅрѕЇ ріарѕюрѕфріФріЋ рІФрѕ│рІФрѕЇ
­ЪїЈ	рѕЅрѕЇ ріЦрѕхрІФ-ріарІЇрѕхрЅхрѕФрѕірІФріЋ рІФрѕ│рІФрѕЇ
­Ъїљ	рѕЅрѕЇ ріерѕюрѕфрІхрІФріЋ рїІрѕГ
­ЪЌ║№ИЈ	рІерІЊрѕѕрѕЮ ріФрѕГрЅ│
­ЪЌ║	рІерІЊрѕѕрѕЮ ріФрѕГрЅ│
­ЪЌЙ	рІерїЃрЇЊріЋ ріФрѕГрЅ│
­ЪДГ	рі«рѕЮрЇЊрѕх
­ЪЈћ№ИЈ	рЅарЅарѕерІХ рІерЅ░рѕИрЇѕріљ рЅ░рѕФрѕФ
­ЪЈћ	рЅарЅарѕерІХ рІерЅ░рѕИрЇѕріљ рЅ░рѕФрѕФ
РЏ░№ИЈ	рЅ░рѕФрѕФ
РЏ░	рЅ░рѕФрѕФ
­ЪїІ	ріЦрѕ│рЅ░ рїѕрѕърѕФ
­ЪЌ╗	рЇЅрїѓ рЅ░рѕФрѕФ
­ЪЈЋ№ИЈ	ріФрѕЮрЇЋ рѕЏрІхрѕерїЇ
­ЪЈЋ	ріФрѕЮрЇЋ рѕЏрІхрѕерїЇ
­ЪЈќ№ИЈ	рІерЅБрѕЁрѕГ рІ│рѕГрЅ╗ ріерїЃріЋрїЦрѕІ рїІрѕГ
­ЪЈќ	рІерЅБрѕЁрѕГ рІ│рѕГрЅ╗ ріерїЃріЋрїЦрѕІ рїІрѕГ
­ЪЈю№ИЈ	рЅарѕерѕЃ
­ЪЈю	рЅарѕерѕЃ
­ЪЈЮ№ИЈ	рІерЅарѕерѕЃ рІ░рѕ┤рЅх
­ЪЈЮ	рІерЅарѕерѕЃ рІ░рѕ┤рЅх
­ЪЈъ№ИЈ	рЅЦрѕёрѕФрІі рЇЊрѕГріГ
­ЪЈъ	рЅЦрѕёрѕФрІі рЇЊрѕГріГ
­ЪЈЪ№ИЈ	рѕхрЅ│рІ▓рІерѕЮ
­ЪЈЪ	рѕхрЅ│рІ▓рІерѕЮ
­ЪЈЏ№ИЈ	ріГрѕІрѕ▓ріФрѕЇ рѕЋріЋрЇЃ
­ЪЈЏ	ріГрѕІрѕ▓ріФрѕЇ рѕЋріЋрЇЃ
­ЪЈЌ№ИЈ	рІерїЇріЋрЅБрЅ│ рїЇріЋрЅБрЅ│
­ЪЈЌ	рІерїЇріЋрЅБрЅ│ рїЇріЋрЅБрЅ│
­ЪД▒	рїАрЅдрЅй
­ЪЈў№ИЈ	рЅцрЅХрЅй
­ЪЈў	рЅцрЅХрЅй
­ЪЈџ№ИЈ	рІерЅ░рЅарѕІрѕИ рЅцрЅх
­ЪЈџ	рІерЅ░рЅарѕІрѕИ рЅцрЅх
­ЪЈа	рЅцрЅх
­ЪЈА	рІеріарЅхріГрѕЇрЅх рѕхрЇЇрѕФ рІФрѕѕрІЇ рЅцрЅх
­ЪЈб	рІерЅбрѕ« рѕЁріЋрЇЃ
­ЪЈБ	рІерїЃрЇЊріЋ рЇќрѕхрЅ│ рЅцрЅх
­ЪЈц	рЇќрѕхрЅ│ рЅцрЅх
­ЪЈЦ	рѕєрѕхрЇњрЅ│рѕЇ
­ЪЈд	рЅБріЋріГ
­ЪЈе	рѕєрЅ┤рѕЇ
­ЪЈЕ	рІерЇЇрЅЁрѕГ рѕєрЅ┤рѕЇ
­ЪЈф	рѕЮрЅ╣ рѕўрІ░рЅЦрѕГ
­ЪЈФ	рЅхрѕЮрѕЁрѕГрЅх рЅцрЅх
­ЪЈг	рЅарЅ░рѕѕрІФрІЕ ріГрЇјрѕјрЅй рІерЅ░рІ░рѕФрїђ рїЇрІЎрЇЇ рѕЏріерЇІрЇѕрІФ
­ЪЈГ	рЇІрЅЦрѕфріФ
­ЪЈ»	рІерїЃрЇЊріЋ рЅцрЅ░рѕўріЋрїЇрѕхрЅх
­ЪЈ░	рЅцрЅ░рѕўріЋрїЇрѕхрЅх
­Ъњњ	рѕ░рѕГрїЇ
­ЪЌ╝	рІерЅХріфрІ« рїЇріЋрЅЦ
­ЪЌй	рІеріљрї╗ріљрЅх рѕЃрІЇрѕЇрЅх
РЏф	рЅцрЅ░ ріГрѕГрѕхрЅ▓рІФріЋ
­ЪЋї	рѕўрѕхрїірІх
­ЪЋЇ	рѕЮріЕрѕФрЅЦ
РЏЕ№ИЈ	рІерѕ║ріЋрЅХ рѕўрЅЁрІ░рѕх
РЏЕ	рІерѕ║ріЋрЅХ рѕўрЅЁрІ░рѕх
­ЪЋІ	ріФрЅБ
РЏ▓	рѕЮріЋрїГ
РЏ║	рІхріЋрі│ріЋ
­ЪїЂ	рїГрїІрїІрѕЏ
­ЪїЃ	рѕЮрѕйрЅх ріерІІріГрЅЦрЅх рїІрѕГ
­ЪЈЎ№ИЈ	рІеріерЅ░рѕЏ рїѕрїйрЅ│
­ЪЈЎ	рІеріерЅ░рѕЏ рїѕрїйрЅ│
­Ъїё	рЅарЅ░рѕФрѕ«рЅй рѕІрІГ рІерЇђрѕљрІГ рѕўрІЇрїБрЅх
­ЪїЁ	рІерЇђрѕљрІГ рѕўрІЇрїБрЅх
­Ъїє	рЅарѕўрѕИ рїірІю рІеріерЅ░рѕЏ рїѕрїйрЅ│
­ЪїЄ	рїђріЋрЅарѕГ рѕхрЅхрїарѕЇрЅЁ
­ЪїЅ	рѕЮрѕйрЅх рѕІрІГ рІхрѕЇрІхрІГ
РЎе№ИЈ	рѕЎрЅЁ рѕЮріЋрї«рЅй
РЎе	рѕЎрЅЁ рѕЮріЋрї«рЅй
­Ъїї	рѕџрѕЇріГ рІїрІГ
­Ъја	ріФрѕ«рѕ┤рѕЇ рЇѕрѕерѕх
­ЪјА	рІерЇїрѕфрѕх рїјрѕЏ
­Ъјб	рЅ░рїарЅЁрѕІрІГ рЅ░рІѕрѕГрІІрѕф
­Ъњѕ	рІерЇђрїЅрѕГ ріарѕхрЅ░ріФріФрІ«рЅй рѕЮрѕ░рѕХ
­Ъјф	рІерѕ░рѕГріерѕх рІхріЋрі│ріЋ
­Ъџѓ	рѕјрі«рѕърЅ▓рЅГ
­ЪџЃ	рІерЅБрЅАрѕГ рѕўріфріЊ
­Ъџё	ріерЇЇрЅ░ріЏ рЇЇрїЦріљрЅх рІФрѕѕрІЇ рЅБрЅАрѕГ
­ЪџЁ	рїЦрІГрЅх рЅБрЅАрѕГ
­Ъџє	рЅБрЅАрѕГ
­ЪџЄ	рѕюрЅхрѕ«
­Ъџѕ	рЅђрѕІрѕЇ рЅБрЅАрѕГ
­ЪџЅ	рѕўрѕБрЇѕрѕфрІФ
­Ъџі	рЅхрѕФрѕЮ
­ЪџЮ	monorail
­Ъџъ	рІерЅ░рѕФрѕФ рЅБрЅАрѕГ
­ЪџІ	рЅхрѕФрѕЮ рѕўріфріЊ
­Ъџї	ріарІЇрЅХрЅАрѕх
­ЪџЇ	рѕўрїф ріарІЇрЅХрЅАрѕх
­Ъџј	рЅхрѕ«рѕірЅБрѕх
­Ъџљ	рѕџріњрЅБрѕх
­ЪџЉ	ріарѕЮрЅАрѕІріЋрѕх
­Ъџњ	рІерѕўріЋрІ░рїЃ рѕърЅ░рѕГ
­ЪџЊ	рІерЇќрѕірѕх рѕўріфріЊ
­Ъџћ	рІерѕџрѕўрїБрІЇ рІерЇќрѕірѕх рѕўріфріЊ
­ЪџЋ	рЅ│ріГрѕ▓
­Ъџќ	рІерѕџрѕўрїБрІЇ рЅ│ріГрѕ▓
­ЪџЌ	рѕўріфріЊ
­Ъџў	рѕўрїф рѕўріфріЊ
­ЪџЎ	рІерѕхрЇќрѕГрЅх рѕўрїѕрѕЇрїѕрІФ рѕўріфріЊ
­Ъџџ	рІерѕўрѕІріфрІФ рѕўріфріЊ
­ЪџЏ	articulated рѕјрѕф
­Ъџю	рЅхрѕФріГрЅ░рѕГ
­Ъџ▓	рЅЦрѕхріГрѕїрЅх
­ЪЏ┤	рІерѕўрѕГрїѕрїЦ рѕхріЕрЅ░рѕГ
­ЪЏ╣	рІерѕхрігрЅхрЅдрѕГрІх
­ЪЏх	рѕърЅ░рѕГ рѕхріЕрЅ░рѕГ
­ЪџЈ	рІеріарІЇрЅХрЅАрѕх рѕЏрЅєрѕџрІФ
­ЪЏБ№ИЈ	ріарІЇрѕФ рїјрІ│ріЊ
­ЪЏБ	ріарІЇрѕФ рїјрІ│ріЊ
­ЪЏц№ИЈ	рІерЅБрЅАрѕГ рѕђрІ▓рІх
­ЪЏц	рІерЅБрЅАрѕГ рѕђрІ▓рІх
­ЪЏб№ИЈ	рІўрІГрЅх ріерЅарѕ«
­ЪЏб	рІўрІГрЅх ріерЅарѕ«
РЏй	рІеріљрІ│рїЁ рЇЊрѕЮрЇЋ
­Ъџе	рІерЇќрѕірѕх рѕўріфріЊ рѕўрЅЦрѕФрЅх
­ЪџЦ	ріарїЇрІхрѕЮ рІерЅхрѕФрЇіріГ рѕўрЅЦрѕФрЅх
­Ъџд	рЅђрїЦ рІФрѕѕ рІерЅхрѕФрЇіріГ рѕўрЅЦрѕФрЅх
­ЪЏЉ	рЅЂрѕЮ рѕЮрѕЇріГрЅх
­ЪџД	рїЇріЋрЅБрЅ│
РџЊ	рѕўрѕЇрѕЁрЅЁ
РЏх	рїђрѕЇрЅБ
­ЪЏХ	рЅ│ріЋрі│
­Ъџц	рЇѕрїБріЋ рїђрѕЇрЅБ
­ЪЏ│№ИЈ	рІерѕўріЋрїѕрІ░ріърЅй рѕўрѕГріерЅЦ
­ЪЏ│	рІерѕўріЋрїѕрІ░ріърЅй рѕўрѕГріерЅЦ
РЏ┤№ИЈ	рїђрѕЇрЅБ
РЏ┤	рїђрѕЇрЅБ
­ЪЏЦ№ИЈ	рІерѕърЅ░рѕГ рїђрѕЇрЅБ
­ЪЏЦ	рІерѕърЅ░рѕГ рїђрѕЇрЅБ
­Ъџб	рѕўрѕГріерЅЦ
Рюѕ№ИЈ	ріарІЇрѕ«рЇЋрѕІріЋ
Рюѕ	ріарІЇрѕ«рЇЋрѕІріЋ
­ЪЏЕ№ИЈ	рЅхріЋрѕй ріарІЇрѕ«рЇЋрѕІріЋ
­ЪЏЕ	рЅхріЋрѕй ріарІЇрѕ«рЇЋрѕІріЋ
­ЪЏФ	рІеріарІЇрѕ«рЇЋрѕІріЋ рѕўріљрѕ│рЅх
­ЪЏг	рІеріарІЇрѕ«рЇЋрѕІріЋ рѕўрѕЮрїБрЅх
­Ъњ║	рѕўрЅђрѕўрїФ
­ЪџЂ	рѕёрѕірі«рЇЋрЅ░рѕГ
­ЪџЪ	рІерЅ░ріЋрїарѕѕрїарѕѕ рЅБрЅАрѕГ
­Ъџа	рІерЅ░рѕФрѕФ рІерігрЅЦрѕЇ рѕўріЋрїѕрІх
­ЪџА	рІеріарІерѕГ рЅхрѕФрѕЮ рѕўріЋрїѕрІх
­ЪЏ░№ИЈ	рѕ│рЅ░рѕІрІГрЅх
­ЪЏ░	рѕ│рЅ░рѕІрІГрЅх
­Ъџђ	рѕ«рігрЅх
­ЪЏИ	рІерѕџрЅарѕГ рѕ│рІЇрѕ░рѕГ
­ЪЏј№ИЈ	рІ░рІѕрѕЇ рІ░рІѕрѕЇ
­ЪЏј	рІ░рІѕрѕЇ рІ░рІѕрѕЇ
­ЪД│	рѕ╗ріЋрїБрІјрЅй
РїЏ	рІерѕ░рІЊрЅх рЅЦрѕГрїГрЅє рЅ░рѕарѕГрЅирѕЇ
РЈ│	рІерѕ░рІЊрЅх рѕўрѕхрЅ│рІѕрЅх ріарѕЇрЅ░рѕ░рѕФрѕЮрЇб
Рїџ	рІГрѕўрѕЇріерЅ▒
РЈ░	рѕЏріЋрЅѓрІФ рІ░рІЇрѕЇ
РЈ▒№ИЈ	рІерѕЕрїФ рѕ░рІЊрЅх
РЈ▒	рІерѕЕрїФ рѕ░рІЊрЅх
РЈ▓№ИЈ	рІерѕ░рІЊрЅх рЅєрїБрѕф рѕ░рІЊрЅх
РЈ▓	рІерѕ░рІЊрЅх рЅєрїБрѕф рѕ░рІЊрЅх
­ЪЋ░№ИЈ	mantelpiece рѕ░рІЊрЅх
­ЪЋ░	mantelpiece рѕ░рІЊрЅх
­ЪЋЏ	ріарѕхрѕФ рѕЂрѕѕрЅх рѕ░рІЊрЅх
­ЪЋД	ріарѕЦрѕФ рѕЂрѕѕрЅх рѕарѕІрѕ│
­ЪЋљ	ріаріЋрІх рѕ░рІЊрЅх
­ЪЋю	ріаріЋрІх рѕарѕІрѕ│
­ЪЋЉ	рѕЂрѕѕрЅх рѕ░рІЊрЅх
­ЪЋЮ	рѕЂрѕѕрЅх рЅ░ріЕрѕЇ
­ЪЋњ	рѕХрѕхрЅх рѕ░рІЊрЅх
­ЪЋъ	рѕдрѕхрЅх рЅ░ріЕрѕЇ
­ЪЋЊ	ріарѕФрЅх рѕ░рІЊрЅх
­ЪЋЪ	ріарѕФрЅх рѕарѕІрѕ│
­ЪЋћ	ріарѕЮрѕхрЅх рѕ░рІЊрЅх
­ЪЋа	ріарѕЮрѕхрЅх рЅ░ріЕрѕЇ
­ЪЋЋ	рѕхрІхрѕхрЅх рѕ░рІЊрЅх
­ЪЋА	рѕхрІхрѕхрЅх рЅ░ріЕрѕЇ
­ЪЋќ	рѕ░рЅБрЅх рѕ░рІЊрЅх
­ЪЋб	рѕ░рЅБрЅх рЅ░ріЕрѕЇ
­ЪЋЌ	рѕхрѕЮріЋрЅх рѕ░рІЊрЅх
­ЪЋБ	рѕхрѕЮріЋрЅх рЅ░ріЕрѕЇ
­ЪЋў	рІўрїаріЮ рѕ░рІЊрЅх
­ЪЋц	рІўрїаріЮ рѕарѕІрѕ│
­ЪЋЎ	ріарѕхрѕГ рѕ░ріарЅх
­ЪЋЦ	ріарѕхрѕГ рЅ░ріЕрѕЇ
­ЪЋџ	ріарѕЦрѕФ ріаріЋрІх рѕ░рІЊрЅх
­ЪЋд	ріарѕЦрѕФ ріаріЋрІх рѕарѕІрѕ│
­ЪїЉ	ріарІ▓рѕх рїерѕерЅЃ
­Ъїњ	ріЦрІерїерѕўрѕе рІерѕџрѕёрІ░рІЇ рїерѕерЅЃ
­ЪїЊ	рІерѕўрїђрѕўрѕфрІФ рѕЕрЅЦ рїерѕерЅЃ
­Ъїћ	ріЦрІерїерѕўрѕе рІерѕџрѕёрІх рїерѕерЅЃ
­ЪїЋ	рѕЎрѕЅ рїерѕерЅЃ
­Ъїќ	ріЦрІерЅђріљрѕ░ рІерѕЮрЅхрѕёрІх рїерѕерЅЃ
­ЪїЌ	рІерѕўрїерѕерѕ╗рІЇ рѕЕрЅЦ рїерѕерЅЃ
­Ъїў	ріЦрІерЅђріљрѕ░ рІерїерѕерЅЃ рїерѕерЅЃ
­ЪїЎ	рІерїерѕерЅЃ рїерѕерЅЃ
­Ъїџ	ріарІ▓рѕх рїерѕерЅЃ рЇірЅх
­ЪїЏ	рІерѕўрїђрѕўрѕфрІФ рѕЕрЅЦ рїерѕерЅЃ рЇірЅх
­Ъїю	рІерѕўрїерѕерѕ╗рІЇ рѕЕрЅЦ рїерѕерЅЃ рЇірЅх
­ЪїА№ИЈ	рЅ┤рѕГрѕърѕюрЅхрѕГ
­ЪїА	рЅ┤рѕГрѕърѕюрЅхрѕГ
Рўђ№ИЈ	рЇђрѕљрІГ
Рўђ	рЇђрѕљрІГ
­ЪїЮ	рѕЎрѕЅ рїерѕерЅЃ рЇірЅх
­Ъїъ	рЇђрѕљрІГ ріерЇірЅх рїІрѕГ
РГљ	рі«ріерЅЦ
­ЪїЪ	рІерѕџрІФрЅарѕФ рі«ріерЅЦ
­Ъїа	рЅ░рІѕрѕГрІІрѕф рі«ріерЅЦ
РўЂ№ИЈ	рІ░рѕўріЊ
РўЂ	рІ░рѕўріЊ
РЏЁ	рЇђрѕљрІГ ріерІ░рѕўріЊ рїђрѕГрЅБ
РЏѕ№ИЈ	рІ░рѕўріЊ рЅарѕўрЅЦрѕерЅЁ ріЦріЊ рЅарІЮріЊрЅЦ
РЏѕ	рІ░рѕўріЊ рЅарѕўрЅЦрѕерЅЁ ріЦріЊ рЅарІЮріЊрЅЦ
­Ъїц№ИЈ	рЇђрѕљрІГ ріерЅхріЋрѕй рІ░рѕўріЊ рїђрѕГрЅБ
­Ъїц	рЇђрѕљрІГ ріерЅхріЋрѕй рІ░рѕўріЊ рїђрѕГрЅБ
­ЪїЦ№ИЈ	рЇђрѕљрІГ ріерЅхрѕЇрЅЁ рІ░рѕўріЊ рїђрѕГрЅБ
­ЪїЦ	рЇђрѕљрІГ ріерЅхрѕЇрЅЁ рІ░рѕўріЊ рїђрѕГрЅБ
­Ъїд№ИЈ	рЇђрѕљрІГ ріерІЮріЊрЅЦ рІ░рѕўріЊ рЅарѕхрЅ░рїђрѕГрЅБ
­Ъїд	рЇђрѕљрІГ ріерІЮріЊрЅЦ рІ░рѕўріЊ рЅарѕхрЅ░рїђрѕГрЅБ
­ЪїД№ИЈ	рІ░рѕўріЊ ріерІЮріЊрЅЦ рїІрѕГ
­ЪїД	рІ░рѕўріЊ ріерІЮріЊрЅЦ рїІрѕГ
­Ъїе№ИЈ	рІ░рѕўріЊ ріерЅарѕерІХ рїІрѕГ
­Ъїе	рІ░рѕўріЊ ріерЅарѕерІХ рїІрѕГ
­ЪїЕ№ИЈ	рІ░рѕўріЊ ріерѕўрЅЦрѕерЅЁ рїІрѕГ
­ЪїЕ	рІ░рѕўріЊ ріерѕўрЅЦрѕерЅЁ рїІрѕГ
­Ъїф№ИЈ	ріарІЇрѕј ріљрЇІрѕх
­Ъїф	ріарІЇрѕј ріљрЇІрѕх
­ЪїФ№ИЈ	рїГрїІрїЇ
­ЪїФ	рїГрїІрїЇ
­Ъїг№ИЈ	рІеріЋрЇІрѕх рЇірЅх
­Ъїг	рІеріЋрЇІрѕх рЇірЅх
­Ъїђ	ріарІЇрѕј ріЋрЇІрѕх
­Ъїѕ	рЅђрѕхрЅ░ рІ░рѕўріЊ
­Ъїѓ	рІерЅ░рІўрїІ рїЃріЋрїЦрѕІ
Рўѓ№ИЈ	рІБріЋрїЦрѕІ
Рўѓ	рІБріЋрїЦрѕІ
Рўћ	рІерІЮріЊрЅЦ рїарЅЦрЅ│рІјрЅй рІФрѕѕрІЇ рїЃріЋрїЦрѕІ
РЏ▒№ИЈ	рѕўрѕгрЅх рѕІрІГ рїЃріЋрїЦрѕІ
РЏ▒	рѕўрѕгрЅх рѕІрІГ рїЃріЋрїЦрѕІ
РџА	ріерЇЇрЅ░ріЏ рЅ«рѕЇрЅ┤рїЁ
РЮё№ИЈ	рІерЅарѕерІХ рЅЁріЋрїБрЅх
РЮё	рІерЅарѕерІХ рЅЁріЋрїБрЅх
РўЃ№ИЈ	рІерЅарѕерІХ рѕ░рІЇ
РўЃ	рІерЅарѕерІХ рѕ░рІЇ
РЏё	рІерЅарѕерІХ рѕ░рІЇ рІФрѕѕ рЅарѕерІХ
Рўё№ИЈ	рі«рѕюрЅх
Рўё	рі«рѕюрЅх
­ЪћЦ	ріЦрѕ│рЅх
­ЪњД	ріљрїарЅЦрїБрЅЦ
­Ъїі	рІерІЇрѕЃ рѕърїѕрІх
­ЪјЃ	рїЃріГ-рід-рѕІріЋрЅ░рѕГріЋ
­Ъјё	рІерїѕріЊ рІЏрЇЇ
­Ъјє	рѕГрЅйрЅХрЅй
­ЪјЄ	рЅЦрѕЇрїГрѕЇрїГ
­ЪДе	рЇІрІерѕГріГрѕФріерѕГ
Рюе	рЅЦрѕЇрїГ рІхрѕГрїЇрѕЮ рІГрѕІрѕЇ
­Ъјѕ	рЇіріЏ
­ЪјЅ	рЇЊрѕГрЅ▓ рЇќрЇљрѕГ
­Ъјі	рі«ріЋрЇѕрЅ▓ рі│рѕх
­ЪјІ	рЅ│ріЊрЅБрЅ│ рІЏрЇЇ
­ЪјЇ	рІерїЦрІх рѕЏрѕхрїїрїЦ
­Ъјј	рІерїЃрЇЊріЋ ріарѕ╗ріЋрїЅрѕірЅХрЅй
­ЪјЈ	рІеріФрѕГрЇЋ рІѕрѕФрїЁ
­Ъјљ	рІеріЋрЇІрѕх рїЕріИрЅх
­ЪјЉ	рІерїерѕерЅЃ ріЦрІГрЅ│ рѕЦріљ рѕЦрѕГрІЊрЅх
­ЪДД	рЅђрІГ рЇќрѕхрЅ│
­Ъјђ	рѕфрЅБріЋ
­ЪјЂ	рІерЅ│рѕИрїѕ рѕхрїдрЅ│
­ЪјЌ№ИЈ	ріарѕхрЅ│рІІрѕй рѕфрЅБріЋ
­ЪјЌ	ріарѕхрЅ│рІІрѕй рѕфрЅБріЋ
­ЪјЪ№ИЈ	рІерѕўрїЇрЅбрІФ рЅхрігрЅХрЅй
­ЪјЪ	рІерѕўрїЇрЅбрІФ рЅхрігрЅХрЅй
­ЪјФ	рЅхрігрЅх
­Ъјќ№ИЈ	рІѕрЅ│рІ░рѕФрІі рѕюрІ│рѕірІФ
­Ъјќ	рІѕрЅ│рІ░рѕФрІі рѕюрІ│рѕірІФ
­ЪЈє	рІІріЋрїФ
­ЪЈЁ	рІерѕхрЇќрѕГрЅх рѕюрІ│рѕірІФ
­ЪЦЄ	1ріЏ рІ░рѕерїЃ рѕюрІ│рѕірІФ
­ЪЦѕ	2ріЏ рѕюрІ│рѕірІФ
­ЪЦЅ	3 ріЏ рІ░рѕерїЃ рѕюрІ│рѕірІФ
Рџй	рІеріЦрїЇрѕГ рі│рѕх рі│рѕх
РџЙ	рЅцрІЮрЅдрѕЇ
­ЪЦј	рѕѕрѕхрѕІрѕ│ рі│рѕх
­ЪЈђ	рІерЅЁрѕГрїФрЅх рі│рѕх
­ЪЈљ	рЅ«рѕірЅдрѕЇ
­ЪЈѕ	рІеріарѕюрѕфріФ ріЦрїЇрѕГ рі│рѕх
­ЪЈЅ	рѕФрїЇрЅб ріЦрїЇрѕГ рі│рѕх
­ЪјЙ	рЅ┤ріњрѕх
­ЪЦЈ	рІерѕџрЅарѕГ рІ▓рѕхріГ
­Ъј│	рЅдрІЇрѕіріЋрїЇ
­ЪЈЈ	рІеріГрѕфрігрЅх рїерІІрЅ│
­ЪЈЉ	рІерѕўрѕхріГ рѕєріф
­ЪЈњ	рІерЅарѕерІХ рѕєріф
­ЪЦЇ	рѕІріГрѕ«рѕх
­ЪЈЊ	рІерїарѕерї┤рІЏ рЅ┤ріњрѕх
­ЪЈИ	рЅБрІхрѕџріЋрЅ░ріЋ
­ЪЦі	рІерЅдріГрѕх рїЊріЋрЅх
­ЪЦІ	рѕЏрѕГрѕ╗рѕЇ ріарѕГрЅх рІЕріњрЇјрѕГрѕЮ
­ЪЦЁ	рїЇрЅЦ рѕўрѕерЅЦ
РЏ│	рїЅрІхрїЊрІх рІЇрѕхрїЦ рЅБріЋрІ▓рѕФ
РЏИ№ИЈ	рЅарѕерІХ рѕІрІГ рѕўріЋрѕИрѕФрЅ░рЅхріЊ
РЏИ	рЅарѕерІХ рѕІрІГ рѕўріЋрѕИрѕФрЅ░рЅхріЊ
­ЪјБ	рІерІЊрѕБ рѕЏрїЦрѕўрїЃ рѕЮрѕ░рѕХ
­Ъјй	рІерѕЕрїФ рѕИрѕџрІЮ
­Ъј┐	рѕхріфрІјрЅй
­ЪЏи	рѕхрѕІрІГрІх
­ЪЦї	рїарѕўрІЮрѕЏрІЏ рІхріЋрїІрІГ
­Ъј»	рЅарЅђрїЦрЅ│ рѕўрѕЮрЅ│рЅх
­Ъј▒	рїѕріЋрІ│ 8 рі│рѕх
­Ъћ«	ріГрѕфрѕхрЅ│рѕЇ рі│рѕх
­ЪД┐	nazar amulet
­Ъј«	рЅарі«рѕЮрЇњрІЇрЅ░рѕГріЊ рѕўрѕ░рѕЇ рѕўрѕ│рѕфрІФрІјрЅй рѕІрІГ рІерѕџрїФрІѕрЅ▒рЅх рїерІІрЅ│
­ЪЋ╣№ИЈ	рїєрІГрѕхрЅ▓ріГ
­ЪЋ╣	рїєрІГрѕхрЅ▓ріГ
­Ъј░	рѕЏрѕхрїѕрЅбрІФ рѕЏрѕйріЋ
­Ъј▓	рїерІІрЅ│ рѕўрѕърЅх
­ЪДЕ	jigsaw
­ЪДИ	рЅ┤рІ▓ рЅбрѕГ
РЎа№ИЈ	рІерѕхрЇЊрІх рѕЇрЅЦрѕх
РЎа	рІерѕхрЇЊрІх рѕЇрЅЦрѕх
РЎЦ№ИЈ	рІерѕЇрЅЦ рѕЇрЅЦрѕх
РЎЦ	рІерѕЇрЅЦ рѕЇрЅЦрѕх
РЎд№ИЈ	рІеріарѕЇрѕЏрІЮ рѕЇрЅЦрѕх
РЎд	рІеріарѕЇрѕЏрІЮ рѕЇрЅЦрѕх
РЎБ№ИЈ	рІеріГрѕѕрЅЦ рѕЇрЅЦрѕх
РЎБ	рІеріГрѕѕрЅЦ рѕЇрЅЦрѕх
РЎЪ№ИЈ	рІерЅ╝рІЮ рЇЊрІЇріЋ
РЎЪ	рІерЅ╝рІЮ рЇЊрІЇріЋ
­ЪЃЈ	рЅђрѕЇрІ░ріЏ
­Ъђё	рІерѕЏрѕЁрїєріЋрїЇ рЅђрІГ рІхрѕФрїјріЋ
­Ъј┤	рІеріарЅарЅБ рѕўрїФрІѕрЅ╗ ріФрѕГрІХрЅй
­ЪјГ	рїЦрЅарЅдрЅйріЋ рѕЏріеріЊрІѕріЋ
­Ъќ╝№ИЈ	рІерЅ░рЅђрѕерїИ рѕЮрѕхрѕЇ
­Ъќ╝	рІерЅ░рЅђрѕерїИ рѕЮрѕхрѕЇ
­Ъје	ріарѕГрЅ▓рѕхрЅх рЅцрЅ░-рѕхрІЋрѕЇ
­ЪДх	ріГрѕГ
­ЪДХ	ріГрѕГ
­ЪћЄ	рІхрѕЮрїИ-ріерѕЇ рІерЅ░рІ░рѕерїѕ рІхрѕЮрїй рѕЏрїЅрІФ
­Ъћѕ	рІерІхрѕЮрїй рѕЏрїЅрІФ рІЮрЅЁрЅ░ріЏ рІхрѕЮрїй
­ЪћЅ	рЅ░ріЊрїІрѕф рѕўріФріерѕѕріЏ рѕўрїаріЋ
­Ъћі	рІхрѕЮрїй рѕЏрїЅрІФ ріерЇЇрЅ░ріЏ рІхрѕЮрїй
­ЪЊб	рІхрѕЮрїй рѕЏрїЅрІФ
­ЪЊБ	рѕюрїІрЇјріЋ
­ЪЊ»	рІерЇќрѕхрЅ│ рЅђріЋрІх
­Ъћћ	рІ░рІѕрѕЇ
­ЪћЋ	рІ░рІѕрѕЇ рЅарЅєрѕГрЅєрѕ«
­Ъј╝	рІерѕЎрІџрЅЃ рІЇрїцрЅх
­Ъјх	рІерѕЎрІџрЅЃ рѕЏрѕхрЅ│рІѕрѕ╗
­ЪјХ	рІерѕЎрІџрЅЃ рѕЏрѕхрЅ│рІѕрѕ╗рІјрЅй
­ЪјЎ№ИЈ	рѕхрЅ▒рІ▓рІ« рѕЏрІГріГрѕ«рЇјріЋ
­ЪјЎ	рѕхрЅ▒рІ▓рІ« рѕЏрІГріГрѕ«рЇјріЋ
­Ъјџ№ИЈ	рІ░рѕерїЃ рЅ░ріЋрѕИрѕФрЅ│рЅй
­Ъјџ	рІ░рѕерїЃ рЅ░ріЋрѕИрѕФрЅ│рЅй
­ЪјЏ№ИЈ	рІерѕўрЅєрїБрїарѕфрІФ рЅЂрѕЇрЇјрЅй
­ЪјЏ	рІерѕўрЅєрїБрїарѕфрІФ рЅЂрѕЇрЇјрЅй
­Ъјц	рѕЏрІГріГрѕ«рЇјріЋ
­ЪјД	рІерїєрѕ« рѕЏрІ│рѕўрїФ
­ЪЊ╗	рѕгрІ▓рІ«
­Ъји	рѕ│ріГрѕхрЇјріЋ
­ЪјИ	рїірЅ│рѕГ
­Ъј╣	рІерѕЎрІџрЅЃ рЅЂрѕЇрЇЇ рѕ░рѕїрІ│
­Ъј║	рѕўрѕѕріерЅх
­Ъј╗	рЅФрІ«рѕіріЋ
­ЪЦЂ	ріерЅарѕ«
­ЪЊ▒	рѕърЅБрІГрѕЇ
­ЪЊ▓	рЅ░ріЋрЅђрѕ│рЅЃрѕй рѕхрѕЇріГ ріерЅђрѕхрЅх рїІрѕГ
Рўј№ИЈ	рѕхрѕЇріГ
Рўј	рѕхрѕЇріГ
­ЪЊъ	рІерѕхрѕЇріГ рѕўрЅђрЅарІФ
­ЪЊЪ	рЇћрїђрѕГ
­ЪЊа	рІерЇІріГрѕх рѕЏрѕйріЋ
­ЪћІ	рЅБрЅхрѕф
­Ъћї	рІеріцрѕїріГрЅхрѕфріГ рѕўрѕ░ріфрІФ
­Ъњ╗	рѕІрЇЋрЅХрЇЋ рі«рѕЮрЇњрЅ░рѕГ
­ЪќЦ№ИЈ	рІ┤рѕхріГрЅХрЇЋ рі«рѕЮрЇњрЅ░рѕГ
­ЪќЦ	рІ┤рѕхріГрЅХрЇЋ рі«рѕЮрЇњрЅ░рѕГ
­Ъќе№ИЈ	ріарЅ│рѕџ
­Ъќе	ріарЅ│рѕџ
Рїе№ИЈ	рІерЅЂрѕЇрЇЇ рѕ░рѕїрІ│
Рїе	рІерЅЂрѕЇрЇЇ рѕ░рѕїрІ│
­Ъќ▒№ИЈ	рІері«рѕЮрЇњрІЇрЅ░рѕГ рѕўрІ│рЇірЅх
­Ъќ▒	рІері«рѕЮрЇњрІЇрЅ░рѕГ рѕўрІ│рЇірЅх
­Ъќ▓№ИЈ	рІерЅхрѕФріГ рі│рѕх
­Ъќ▓	рІерЅхрѕФріГ рі│рѕх
­Ъњй	рІері«рѕЮрЇњрЅ░рѕГ рІ▓рѕхріГ
­ЪњЙ	рЇЇрѕјрЇњ рІ▓рѕхріГ
­Ъњ┐	рідрЇЋрЅ▓ріФрѕЇ рІ▓рѕхріГ
­ЪЊђ	рІ▓рЅфрІ▓
­ЪД«	ріарЅБріерѕх
­ЪјЦ	рІерЇірѕЇрѕЮ ріФрѕюрѕФ
­Ъјъ№ИЈ	рІерЇірѕЇрѕЮ ріГрЇѕрЇјрЅй
­Ъјъ	рІерЇірѕЇрѕЮ ріГрЇѕрЇјрЅй
­ЪЊй№ИЈ	рІерЇірѕЇрѕЮ рЇЋрѕ«рїђріГрЅ░рѕГ
­ЪЊй	рІерЇірѕЇрѕЮ рЇЋрѕ«рїђріГрЅ░рѕГ
­Ъјг	рѕЏрїерЅЦрїерЅЦ рѕ░рѕїрІ│
­ЪЊ║	рЅ┤рѕїрЅфрІЦріЋ
­ЪЊи	ріФрѕюрѕФ
­ЪЊИ	ріФрѕюрѕФ ріерЅЦрѕЇрїГрЅ│ рїІрѕГ
­ЪЊ╣	рІерЅфрІ▓рІ« ріФрѕюрѕФ
­ЪЊ╝	рІерЅфрІ▓рІ« ріФрѕ┤рЅх
­ЪћЇ	ріарїЅрѕі рѕўріљрїйрѕГ рІѕрІ░ рїЇрѕФ рІФрІўріљрЅарѕѕ
­Ъћј	ріарїЅрѕі рѕўріљрїйрѕГ рІѕрІ░ рЅђріЮ рІўріЋрЅарѕЇ
­ЪЋ»№ИЈ	рѕ╗рѕЏ
­ЪЋ»	рѕ╗рѕЏ
­ЪњА	рЅЦрѕГрѕЃріЋ ріарѕЮрЇќрѕЇ
­Ъћд	рІеріЦрїЁ рЅБрЅхрѕф
­ЪЈ«	рЅђрІГ рІерІѕрѕерЅђрЅх рЇІріќрѕх
­ЪЊћ	рѕЏрѕхрЅ│рІѕрѕ╗ рІ░рЅЦрЅ░рѕГ ріерїїрїБрїїрїЦ рѕйрЇІріЋ рїІрѕГ
­ЪЊЋ	рІерЅ░рІўрїІ рѕўрїйрѕљрЇЇ
­ЪЊќ	ріГрЇЇрЅх рѕўрїйрѕљрЇЇ
­ЪЊЌ	ріарѕеріЋрїЊрІ┤ рѕўрїйрѕљрЇЇ
­ЪЊў	рѕ░рѕЏрІФрІі рѕўрїйрѕљрЇЇ
­ЪЊЎ	рЅЦрѕГрЅ▒ріФріЊрѕЏ рѕўрїйрѕљрЇЇ
­ЪЊџ	рѕўрї╗рѕЋрЇЇрЅх
­ЪЊЊ	рѕЏрѕхрЅ│рІѕрѕ╗ рІ░рЅЦрЅ░рѕГ
­ЪЊњ	рѕўрїйрѕљрЇЇ рѕўрІЮрїѕрЅЦ
­ЪЊЃ	рїѕрїй ріеріерѕГрЅЦрѕЇ рїІрѕГ
­ЪЊю	рѕИрЅЦрѕЇрѕЇ
­ЪЊё	рїѕрїй рІѕрІ░ рѕІрІГ рЅхрІГрІЕ
­ЪЊ░	рїІрІюрїБ
­ЪЌъ№ИЈ	рїЦрЅЁрѕЇ рїІрІюрїБ
­ЪЌъ	рїЦрЅЁрѕЇ рїІрІюрїБ
­ЪЊЉ	рІерІЋрѕЇрЅБрЅх рЅхрѕ«рЅй
­Ъћќ	рІЋрѕЇрЅБрЅх
­ЪЈи№ИЈ	рѕўрѕѕрІФ
­ЪЈи	рѕўрѕѕрІФ
­Ъњ░	рІерїѕріЋрІўрЅЦ рЅдрѕГрѕ│
­Ъњ┤	yen рІерЅБріЋріГ ріќрЅх
­Ъњх	рІерІХрѕІрѕГ ріќрЅх
­ЪњХ	рІЕрѕ« рІерЅБріЋріГ ріќрЅх
­Ъњи	рЇЊрІЇріЋрІх рІерЅБріЋріГ ріќрЅх
­ЪњИ	рїѕріЋрІўрЅЦ рЅаріГріЋрЇјрЅй
­Ъњ│	рІерІ▒рЅц ріФрѕГрІх
­ЪДЙ	рІ░рѕерѕ░ріЮ
­Ъњ╣	рїѕрЅарЅ│ ріе yen рїІрѕГ рІГрїерѕЮрѕФрѕЇ
­Ъњ▒	рІерїѕріЋрІўрЅЦ рѕЇрІЇрІЇрїЦ
­Ъњ▓	ріерЅБрІх рІХрѕІрѕГ рѕЮрѕЇріГрЅх
РюЅ№ИЈ	ріцріЋрЅерѕјрЇЋ
РюЅ	ріцріЋрЅерѕјрЇЋ
­ЪЊД	ріб-рѕюрІГрѕЇ
­ЪЊе	рїѕрЅб рЇќрѕхрЅ│
­ЪЊЕ	рЅђрѕхрЅх рІФрѕѕрІЇ рЇќрѕхрЅ│
­ЪЊц	рІерІЇрїф рѕ│рїЦріЋ рЅхрѕф
­ЪЊЦ	inbox рЅхрѕф
­ЪЊд	рїЦрЅЁрѕЇ
­ЪЊФ	рЅБріЋрІ▓рѕФ рІерЅ░рІўрїІрЅарЅх рІерЇќрѕхрЅ│ рѕ│рїЦріЋ
­ЪЊф	рІерЅ░рІўрїІ рІерЇќрѕхрЅ│ рѕ│рїЦріЋ ріе рЅБріЋрІ▓рѕФ рїІрѕГ
­ЪЊг	ріерЇЇ рІФрѕѕ рЅБріЋрІ▓рѕФ рІФрѕѕрІЇ рІерЇќрѕхрЅ│ рѕ│рїЦріЋ рІГріГрЇѕрЅ▒
­ЪЊГ	рІерѕўрѕЇріЦріГрЅх рѕ│рїЦріЋ ріерІѕрѕерІ░ рЅБріЋрІ▓рѕФ рїІрѕГ
­ЪЊ«	рІерЇќрѕхрЅ│ рѕ│рїЦріЋ
­ЪЌ│№ИЈ	рІерІхрѕЮрїй рѕўрѕхрїФ рѕ│рїЦріЋ ріерІхрѕЮрїй рѕўрѕхрїФ рїІрѕГ
­ЪЌ│	рІерІхрѕЮрїй рѕўрѕхрїФ рѕ│рїЦріЋ ріерІхрѕЮрїй рѕўрѕхрїФ рїІрѕГ
РюЈ№ИЈ	ріЦрѕГрѕ│рѕх
РюЈ	ріЦрѕГрѕ│рѕх
Рюњ№ИЈ	рїЦрЅЂрѕГ ріњрЅЦ
Рюњ	рїЦрЅЂрѕГ ріњрЅЦ
­ЪќІ№ИЈ	рЅЦріарѕГ
­ЪќІ	рЅЦріарѕГ
­Ъќі№ИЈ	рЅЦрІЋрѕГ
­Ъќі	рЅЦрІЋрѕГ
­Ъќї№ИЈ	рІерЅђрѕѕрѕЮ рЅЦрѕЕрѕй
­Ъќї	рІерЅђрѕѕрѕЮ рЅЦрѕЕрѕй
­ЪќЇ№ИЈ	ріГрѕФрІ«ріЋ
­ЪќЇ	ріГрѕФрІ«ріЋ
­ЪЊЮ	рѕЏрѕхрЅ│рІѕрѕ╗
­Ъњ╝	рЅдрѕГрѕ│
­ЪЊЂ	рІерЇІрІГрѕЇ ріарЅЃрЇі
­ЪЊѓ	рІерЇІрІГрѕЇ ріарЅЃрЇіріЋ ріГрЇѕрЅх
­ЪЌѓ№ИЈ	рІеріФрѕГрІх рібріЋрІ┤ріГрѕх рѕўріерЇІрЇѕрІФрІјрЅй
­ЪЌѓ	рІеріФрѕГрІх рібріЋрІ┤ріГрѕх рѕўріерЇІрЇѕрІФрІјрЅй
­ЪЊЁ	рІерЅђріЋ рѕўрЅЂрїарѕфрІФ
­ЪЊє	рІерѕўрЅђрІ░рІх рІерЅђріЋ рѕўрЅЂрїарѕфрІФ
­ЪЌњ№ИЈ	spiral notepad
­ЪЌњ	spiral notepad
­ЪЌЊ№ИЈ	рїарѕўрІЮрѕЏрІЏ рІерЅђріЋ рѕўрЅЂрїарѕфрІФ
­ЪЌЊ	spiral рІерЅђріЋ рѕўрЅЂрїарѕфрІФ
­ЪЊЄ	рІеріФрѕГрІх рѕўрѕерїЃ рїарЅІрѕџ
­ЪЊѕ	рѕ░ріЋрїарѕерІЦ ріЦрІерїерѕўрѕе
­ЪЊЅ	рїѕрЅарЅ│ ріЦрІерЅђріљрѕ░
­ЪЊі	рІеріарѕърѕї рїѕрЅарЅ│
­ЪЊІ	рЅЁріЋрїЦрЅЦ рѕ░рѕїрІ│
­ЪЊї	рЇЉрѕйрЇњріЋ
­ЪЊЇ	ріГрЅЦ рЇЉрѕйрЇњріЋ
­ЪЊј	ріарїЇрѕФрЇЇ
­ЪќЄ№ИЈ	рІерЅ░рїѕріЊріЎ рІерІѕрѕерЅђрЅх ріГрѕірЇќрЅй
­ЪќЄ	рІерЅ░рїѕріЊріЎ рІерІѕрѕерЅђрЅх ріГрѕірЇќрЅй
­ЪЊЈ	рЅђрїЦрЅ░ріЏ рїѕрІЦ
­ЪЊљ	рІерѕХрѕхрЅх рѕЏрІЋрІўріЋ рїѕрІб
Рюѓ№ИЈ	рѕўрЅђрѕХрЅй
Рюѓ	рѕўрЅђрѕХрЅй
­ЪЌЃ№ИЈ	рІеріФрѕГрІх рЇІрІГрѕЇ рѕ│рїЦріЋ
­ЪЌЃ	рІеріФрѕГрІх рЇІрІГрѕЇ рѕ│рїЦріЋ
­ЪЌё№ИЈ	рІерѕ░ріљрІх рѕўрІ░рѕГрІ░рѕфрІФ
­ЪЌё	рІерѕ░ріљрІх рѕўрІ░рѕГрІ░рѕфрІФ
­ЪЌЉ№ИЈ	рІерЅєрѕ╗рѕ╗ рЅЁрѕГрїФрЅх
­ЪЌЉ	рІерЅєрѕ╗рѕ╗ рЅЁрѕГрїФрЅх
­Ъћњ	рЅ░рЅєрѕЇрЇЈрѕЇ
­ЪћЊ	рЅ░ріерЇЇрЅирѕЇрЇб
­ЪћЈ	рЅарЅЦрІЋрѕГ рЅ░рЅєрѕЇрЇЈрѕЇ
­Ъћљ	рЅарЅЂрѕЇрЇЇ рЅ░рЅєрѕЇрЇЈрѕЇ
­ЪћЉ	рЅЂрѕЇрЇЇ
­ЪЌЮ№ИЈ	рІерІхрѕ« рЅЂрѕЇрЇЇ
­ЪЌЮ	рІерІхрѕ« рЅЂрѕЇрЇЇ
­Ъће	рѕўрІХрѕ╗
РЏЈ№ИЈ	рѕўрѕЮрѕерїЦ
РЏЈ	рѕўрѕЮрѕерїЦ
Рџњ№ИЈ	рѕўрІХрѕ╗ ріЦріЊ рѕўрѕЮрѕерїЦ
Рџњ	рѕўрІХрѕ╗ ріЦріЊ рѕўрѕЮрѕерїЦ
­ЪЏа№ИЈ	рѕўрІХрѕ╗ ріЦріЊ рЅЂрѕЇрЇЇ
­ЪЏа	рѕўрІХрѕ╗ ріЦріЊ рЅЂрѕЇрЇЇ
­ЪЌА№ИЈ	рїЕрЅц
­ЪЌА	рїЕрЅц
Рџћ№ИЈ	рІерЅ░рѕ╗рїѕрѕЕ рѕ░рІГрЇјрЅй
Рџћ	рІерЅ░рѕ╗рїѕрѕЕ рѕ░рІГрЇјрЅй
­ЪћФ	рѕйрїЅрїЦ
­ЪЈ╣	рЅђрѕхрЅх ріЦріЊ рЅђрѕхрЅх
­ЪЏА№ИЈ	рїІрѕ╗
­ЪЏА	рїІрѕ╗
­ЪћД	рІерѕўрЇЇрЅ╗
­ЪћЕ	ріљрЅх ріЦріЊ рѕўрЅђрѕГрЅђрѕфрІФ
РџЎ№ИЈ	рѕЏрѕГрѕй
РџЎ	рѕЏрѕГрѕй
­ЪЌю№ИЈ	рѕўрЅєріЋрїарїЦ
­ЪЌю	рѕўрЅєріЋрїарїЦ
Рџќ№ИЈ	рѕџрІЏріЋ рѕџрІЏріЋ
Рџќ	рѕџрІЏріЋ рѕџрІЏріЋ
­ЪћЌ	ріарїѕріЊріЮ
РЏЊ№ИЈ	рѕ░ріЋрѕ░рѕѕрЅХрЅй
РЏЊ	рѕ░ріЋрѕ░рѕѕрЅХрЅй
­ЪД░	рІерѕўрѕ│рѕфрІФ рѕ│рїЦріЋ
­ЪД▓	рѕЏрїЇріћрЅх
РџЌ№ИЈ	ріарѕѕрѕЮрЅбріГ
РџЌ	ріарѕѕрѕЮрЅбріГ
­ЪДф	рІерѕЎріерѕФ рЅ▒рЅд
­ЪДФ	рІерЇћрЅхрѕф рѕЮрїЇрЅЦ
­ЪДг	рІ▓.ріцріЋ
­Ъћг	рѕЏрІГріГрѕ«рѕхрі«рЇЋ
­ЪћГ	рЅ┤рѕїрѕхрі«рЇЋ
­ЪЊА	рІерѕ│рЅ░рѕІрІГрЅх ріаріЋрЅ┤ріЊ
­ЪњЅ	рѕўрѕГрЇї
­Ъњі	ріГріњріЋ
­Ъџф	рЅарѕГ
­ЪЏЈ№ИЈ	ріарѕЇрїІ
­ЪЏЈ	ріарѕЇрїІ
­ЪЏІ№ИЈ	рѕХрЇІ ріЦріЊ рѕўрЅЦрѕФрЅх
­ЪЏІ	рѕХрЇІ ріЦріЊ рѕўрЅЦрѕФрЅх
­Ъџй	рѕўрїИрІ│рїЃ рЅцрЅх
­Ъџ┐	рѕ╗рІѕрѕГ
­ЪЏЂ	рІерѕўрЅ│рїарЅбрІФ рїѕріЋрІ│
­ЪД┤	рІерѕјрѕйріЋ рїарѕГрѕЎрѕх
­ЪДи	рѕўрѕГрЇї рЅЂрѕЇрЇЇ
­ЪД╣	рѕўрїЦрѕерїірІФ
­ЪД║	рЅЁрѕГрїФрЅх
­ЪД╗	рїЦрЅЁрѕЇ рІѕрѕерЅђрЅх
­ЪД╝	рѕ│рѕЎріЊ
­ЪДй	рѕхрЇќріЋрїЁ
­ЪД»	рІеріЦрѕ│рЅх рѕЏрїЦрЇірІФ
­ЪЏњ	рІерїЇрІб рїІрѕф
­Ъџг	рѕ▓рїІрѕФ
Рџ░№ИЈ	рІерѕгрѕ│ рѕБрїЦріЋ
Рџ░	рІерѕгрѕ│ рѕБрїЦріЋ
Рџ▒№ИЈ	рІерЅђрЅЦрѕГ рѕЦріљ рѕЦрѕГрІЊрЅх
Рџ▒	рІерЅђрЅЦрѕГ рѕЦріљ рѕЦрѕГрІЊрЅх
­ЪЌ┐	рѕъріарІГ
­ЪЈД	рІеріцрЅ▓ріцрѕЮ рѕЮрѕЇріГрЅх
­Ъџ«	рЅєрѕ╗рѕ╗ рѕўрїБрІФ рІЇрѕхрїЦ
­Ъџ░	рІерѕўрїарїЦ рІЇрѕЃ
РЎ┐	рІерЅ░рѕйріерѕГріФрѕф рІѕріЋрЅарѕГ рѕЮрѕЇріГрЅх
­Ъџ╣	рІерІѕріЋрІХрЅй ріГрЇЇрѕЇ
­Ъџ║	рІерѕ┤рЅХрЅй ріГрЇЇрѕЇ
­Ъџ╗	рѕўрїИрІ│рїЃ рЅцрЅх
­Ъџ╝	рІерѕЋрЇЃріЋ рѕЮрѕЇріГрЅх
­ЪџЙ	рѕўрЅ│рїарЅбрІФ рЅцрЅх
­ЪЏѓ	рІерЇЊрѕхрЇќрѕГрЅх рЅЂрїЦрїЦрѕГ
­ЪЏЃ	рїЅрѕЮрѕЕріГ
­ЪЏё	рІерѕ╗ріЋрїБ рїЦрІФрЅё
­ЪЏЁ	рІерїЇрѕФ рѕ╗ріЋрїБ
Рџа№ИЈ	рѕЏрѕхрїаріЋрЅђрЅѓрІФ
Рџа	рѕЏрѕхрїаріЋрЅђрЅѓрІФ
­ЪџИ	рѕЇрїєрЅй рѕўрѕ╗рїѕрѕГ
РЏћ	рѕўрїЇрЅБрЅх рІерѕѕрѕЮ
­ЪџФ	рІерЅ░ріерѕѕріерѕѕ
­Ъџ│	рѕЮріЋрѕЮ рЅЦрѕхріГрѕїрЅх рІерѕѕрѕЮ
­ЪџГ	рѕЏрїерѕх ріГрѕЇріГрѕЇ ріљрІЇ
­Ъџ»	рЅєрѕ╗рѕ╗ рѕўрїБрІФ рІерѕѕрѕЮрЇб
­Ъџ▒	рІерѕЏрІГрїарїБ рІЇрѕЃ
­Ъџи	рѕЮріЋрѕЮ ріЦрїЇрѕеріърЅй
­ЪЊх	рѕЮріЋрѕЮ рѕърЅБрІГрѕЇ рѕхрѕЇрі«рЅй рІерѕЅрѕЮ
­Ъћъ	ріеріарѕхрѕФ рѕхрѕЮріЋрЅх рЅарЅ│рЅй рѕЏріЋрѕЮ рІерѕѕрѕЮрЇб
Рўб№ИЈ	рѕФрІ▓рІ«ріаріГрЅ▓рЅГ
Рўб	рѕФрІ▓рІ«ріаріГрЅ▓рЅГ
РўБ№ИЈ	рЅБрІ«ріарІЏрѕГрІх
РўБ	рЅБрІ«ріарІЏрѕГрІх
Ргє№ИЈ	рІѕрІ░ рѕІрІГ рЅђрѕхрЅх
Ргє	рІѕрІ░ рѕІрІГ рЅђрѕхрЅх
РєЌ№ИЈ	рІѕрІ░ рЅђріЮ-рЅђріЮ рЅђрѕхрЅх
РєЌ	рІѕрІ░ рЅђріЮ-рЅђріЮ рЅђрѕхрЅх
РъА№ИЈ	рІерЅђріЮ рЅђрѕхрЅх
РъА	рІерЅђріЮ рЅђрѕхрЅх
Рєў№ИЈ	рІерЅ│рЅй-рЅђріЮ рЅђрѕхрЅх
Рєў	рІерЅ│рЅй-рЅђріЮ рЅђрѕхрЅх
РгЄ№ИЈ	рІерЅ│рЅй рЅђрѕхрЅх
РгЄ	рІерЅ│рЅй рЅђрѕхрЅх
РєЎ№ИЈ	рІерЅ│рЅй-рїЇрѕФ рЅђрѕхрЅх
РєЎ	рІерЅ│рЅй-рїЇрѕФ рЅђрѕхрЅх
РгЁ№ИЈ	рІерїЇрѕФ рЅђрѕхрЅх
РгЁ	рІерїЇрѕФ рЅђрѕхрЅх
Рєќ№ИЈ	рІѕрІ░ рѕІрІГ-рїЇрѕФ рЅђрѕхрЅх
Рєќ	рІѕрІ░ рѕІрІГ-рїЇрѕФ рЅђрѕхрЅх
РєЋ№ИЈ	рІѕрІ░ рѕІрІГ-рЅ│рЅй рЅђрѕхрЅх
РєЋ	рІѕрІ░ рѕІрІГ-рЅ│рЅй рЅђрѕхрЅх
Рєћ№ИЈ	рїЇрѕФ-рЅђріЮ рЅђрѕхрЅх
Рєћ	рїЇрѕФ-рЅђріЮ рЅђрѕхрЅх
РєЕ№ИЈ	рІерЅђріЮ рЅђрѕхрЅх рІѕрІ░ рїЇрѕФ рѕўрЅ│рїарЇЇ
РєЕ	рІерЅђріЮ рЅђрѕхрЅх рІѕрІ░ рїЇрѕФ рѕўрЅ│рїарЇЇ
Рєф№ИЈ	рІерїЇрѕФ рЅђрѕхрЅх рІѕрІ░ рЅђріЮ рѕўрЅ│рїарЇЇ
Рєф	рІерїЇрѕФ рЅђрѕхрЅх рІѕрІ░ рЅђріЮ рѕўрЅ│рїарЇЇ
Рц┤№ИЈ	рІѕрІ░ рѕІрІГ рЅ│рїБрЇі рЅђріЮ рЅђрѕхрЅх
Рц┤	рІѕрІ░ рѕІрІГ рЅ│рїБрЇі рЅђріЮ рЅђрѕхрЅх
Рцх№ИЈ	рІѕрІ░ рЅ│рЅй рЅ│рїБрЇі рЅђріЮ рЅђрѕхрЅх
Рцх	рІѕрІ░ рЅ│рЅй рЅ│рїБрЇі рЅђріЮ рЅђрѕхрЅх
­ЪћЃ	рЅарѕ░рІЊрЅх ріарЅЁрїБрїФ рЅђрїЦ рІФрѕЅ рЅђрѕхрЅХрЅй
­Ъћё	рЅарЅ░рЅЃрѕФріњ рѕ░рІЊрЅх ріарЅЁрїБрїФ рЅђрѕхрЅХрЅй ріарІЮрѕФрѕГ
­ЪћЎ	рІеріІрѕІ рЅђрѕхрЅх
­Ъћџ	рІерѕўрїерѕерѕ╗ рЅђрѕхрЅх
­ЪћЏ	рЅђрѕхрЅх рѕІрІГ
­Ъћю	рЅарЅЁрѕГрЅА рЅђрѕхрЅх
­ЪћЮ	рІерѕІрІГ рЅђрѕхрЅх
­ЪЏљ	рІеріарѕЮрѕЇрі« рЅдрЅ│
РџЏ№ИЈ	ріарЅХрѕЮ рѕЮрѕЇріГрЅх
РџЏ	ріарЅХрѕЮ рѕЮрѕЇріГрЅх
­ЪЋЅ№ИЈ	om
­ЪЋЅ	om
РюА№ИЈ	рІерІ│рІірЅх рі«ріерЅЦ
РюА	рІерІ│рІірЅх рі«ріерЅЦ
РўИ№ИЈ	рІерІ▒рѕГрѕЏ рїјрѕЏ
РўИ	рІерІ▒рѕГрѕЏ рїјрѕЏ
Рў»№ИЈ	рІГріЋ рІФріЋрїЇ
Рў»	рІГріЋ рІФріЋрїЇ
РюЮ№ИЈ	рІерѕІрЅ▓ріЋ рѕўрѕхрЅђрѕЇ
РюЮ	рІерѕІрЅ▓ріЋ рѕўрѕхрЅђрѕЇ
Рўд№ИЈ	рІерідрѕГрЅХрІХріГрѕх рѕўрѕхрЅђрѕЇ
Рўд	рІерідрѕГрЅХрІХріГрѕх рѕўрѕхрЅђрѕЇ
Рўф№ИЈ	рі«ріерЅЦ ріЦріЊ рїЇрѕЏрѕй рїерѕерЅЃ
Рўф	рі«ріерЅЦ ріЦріЊ рїЇрѕЏрѕй рїерѕерЅЃ
Рў«№ИЈ	рІерѕ░рѕІрѕЮ рѕЮрѕЇріГрЅх
Рў«	рІерѕ░рѕІрѕЮ рѕЮрѕЇріГрЅх
­ЪЋј	рѕюріќрѕФрѕЁ
­Ъћ»	рЅБрѕѕ рѕхрІхрѕхрЅх рїФрЇЇ рі«ріерЅЦ
РЎѕ	ріарѕфрІерѕх
РЎЅ	рЅ│рІЇрѕерѕх
РЎі	рїђрѕџріњ
РЎІ	ріФріЋрѕ░рѕГ
РЎї	рѕірІ«
РЎЇ	рЅфрѕГрїј
РЎј	рѕірЅЦрѕФ
РЎЈ	рѕхрі«рѕГрЇњрІ«
РЎљ	рѕ│рїЁрЅ│рѕфрІерѕх
РЎЉ	ріФрЇЋрѕфрі«рѕГріЋ
РЎњ	ріарі│рѕфрІерѕх
РЎЊ	рЇњрѕ░рѕх
РЏј	рідрЇірІЕрЅ╣рѕх
­Ъћђ	рЅхрѕФрі«рЅй рЅарІЇрІЮ ріарІЮрѕФрѕГ
­ЪћЂ	рІхрїѕрѕЮ ріарІЮрѕФрѕГ
­Ъћѓ	ріљрїарѕІ ріарІЮрѕФрѕГріЋ рІхрїѕрѕЮ
РќХ№ИЈ	ріарїФрІЇрЅх ріарІЮрѕФрѕГ
РќХ	ріарїФрІЇрЅх ріарІЮрѕФрѕГ
РЈЕ	рЇѕрїБріЋ рІѕрІ░рЇірЅх ріарІЮрѕФрѕГ
РЈГ№ИЈ	рЅђрїБрІГ рЅхрѕФріГ ріарІЮрѕФрѕГ
РЈГ	рЅђрїБрІГ рЅхрѕФріГ ріарІЮрѕФрѕГ
РЈ»№ИЈ	ріарїФрІЇрЅх рІѕрІГрѕЮ рЅБрѕѕрЅарЅх ріарЅЂрѕЮ ріарІЮрѕФрѕГ
РЈ»	ріарїФрІЇрЅх рІѕрІГрѕЮ рЅБрѕѕрЅарЅх ріарЅЂрѕЮ ріарІЮрѕФрѕГ
РЌђ№ИЈ	рІерЅ░рїѕрѕІрЅбрїдрѕй ріарІЮрѕФрѕГ
РЌђ	рІерЅ░рїѕрѕІрЅбрїдрѕй ріарІЮрѕФрѕГ
РЈф	рЇѕрїБріЋ рІерЅ░рїѕрѕІрЅбрїдрѕй ріарІЮрѕФрѕГ
РЈ«№ИЈ	рІерѕўрїерѕерѕ╗рІЇ рЅхрѕФріГ ріарІЮрѕФрѕГ
РЈ«	рІерѕўрїерѕерѕ╗рІЇ рЅхрѕФріГ ріарІЮрѕФрѕГ
­Ъћ╝	рІѕрІ░ рѕІрІГ ріарІЮрѕФрѕГ
РЈФ	рЇѕрїБріЋ ріарІЮрѕФрѕГ
­Ъћй	рІерЅ│рЅй ріарІЮрѕФрѕГ
РЈг	рЅарЇЇрїЦріљрЅх рІѕрІ░рЅ│рЅй ріарІЮрѕФрѕГ
РЈИ№ИЈ	рѕѕріарЇЇрЅ│ ріарЅЂрѕЮ ріарІЮрѕФрѕГ
РЈИ	рѕѕріарЇЇрЅ│ ріарЅЂрѕЮ ріарІЮрѕФрѕГ
РЈ╣№ИЈ	рІерѕЏрЅєрѕџрІФ ріарІЮрѕФрѕГ
РЈ╣	рІерѕЏрЅєрѕџрІФ ріарІЮрѕФрѕГ
РЈ║№ИЈ	рІерѕўрІЮрїѕрЅЦ ріарІЮрѕФрѕГ
РЈ║	рІерѕўрІЮрїѕрЅЦ ріарІЮрѕФрѕГ
РЈЈ№ИЈ	ріарѕхрІѕрїБ ріарІЮрѕФрѕГ
РЈЈ	ріарѕхрІѕрїБ ріарІЮрѕФрѕГ
­Ъјд	рѕ▓ріњрѕЏ
­ЪћЁ	рІ░рЅЦрІЏрІЏ ріарІЮрѕФрѕГ
­Ъћє	рЅЦрѕЕрѕЁ ріарІЮрѕФрѕГ
­ЪЊХ	ріаріЋрЅ┤ріЊ ріарѕърѕїрІјрЅй
­ЪЊ│	рІеріЋрІЮрѕерЅх рѕЂріљрЅ│
­ЪЊ┤	рІерѕърЅБрІГрѕЇ рѕхрѕЇріГ рїарЇЇрЅирѕЇ
РЎђ№ИЈ	рІерѕ┤рЅх рѕЮрѕЇріГрЅх
РЎђ	рІерѕ┤рЅх рѕЮрѕЇріГрЅх
РЎѓ№ИЈ	рІерІѕріЋрІх рѕЮрѕЇріГрЅх
РЎѓ	рІерІѕріЋрІх рѕЮрѕЇріГрЅх
РџЋ№ИЈ	рІерѕЋріГрѕЮріЊ рѕЮрѕЇріГрЅх
РџЋ	рІерѕЋріГрѕЮріЊ рѕЮрѕЇріГрЅх
РЎЙ№ИЈ	рѕЏрѕѕрЅѓрІФ рІерѕїрѕѕрІЇ
РЎЙ	рѕЏрѕѕрЅѓрІФ рІерѕїрѕѕрІЇ
РЎ╗№ИЈ	ріЦріЋрІ░рїѕріЊ рїЦрЅЁрѕЮ рѕІрІГ рѕЏрІІрѕЇ рѕЮрѕЇріГрЅх
РЎ╗	ріЦріЋрІ░рїѕріЊ рїЦрЅЁрѕЮ рѕІрІГ рѕЏрІІрѕЇ рѕЮрѕЇріГрЅх
Рџю№ИЈ	fleur-de-lis
Рџю	fleur-de-lis
­Ъћ▒	рІерѕХрѕхрЅхрІ«рѕй рѕЮрѕЇріГрЅх
­ЪЊЏ	рѕхрѕЮ рЅБрїЁ
­Ъћ░	рІерїЃрЇЊріЋ рѕЮрѕЇріГрЅх рѕѕрїђрѕЏрѕф
РГЋ	ріерЅБрІх рЅхрѕЇрЅЁ ріГрЅЦ
РюЁ	ріљрїГ ріерЅБрІх рѕЮрѕЇріГрЅх
РўЉ№ИЈ	рІерІхрѕЮрїй рѕўрѕхрїФ рѕ│рїЦріЋ ріерЅ╝ріГ рїІрѕГ
РўЉ	рІерІхрѕЮрїй рѕўрѕхрїФ рѕ│рїЦріЋ ріерЅ╝ріГ рїІрѕГ
Рюћ№ИЈ	ріерЅБрІх рѕЮрѕЇріГрЅх
Рюћ	ріерЅБрІх рѕЮрѕЇріГрЅх
Рюќ№ИЈ	ріерЅБрІх рѕЏрЅБрІЏрЅх x
Рюќ	ріерЅБрІх рѕЏрЅБрІЏрЅх x
РЮї	рІерѕўрѕхрЅђрѕЇ рѕЮрѕЇріГрЅх
РЮј	рІерѕўрѕхрЅђрѕЇ рѕЮрѕЇріГрЅх ріарІЮрѕФрѕГ
РъЋ	ріерЅБрІх рІерѕўрІ░рѕўрѕГ рѕЮрѕЇріГрЅх
Ръќ	ріерЅБрІх рІерѕўрЅђріљрѕх рѕЮрѕЇріГрЅх
РъЌ	ріерЅБрІх ріГрЇЇрЇЇрѕЇ рѕЮрѕЇріГрЅх
Ръ░	рІерЅ░рїарѕЏрІўрІў рІЉрІ░рЅх
Ръ┐	рІхрѕГрЅЦ рїЦрѕЮрІЮ loop
сђй№ИЈ	ріГрЇЇрѕЇ рЅ░рѕѕрІІрїГ рѕЮрѕЇріГрЅх
сђй	ріГрЇЇрѕЇ рЅ░рѕѕрІІрїГ рѕЮрѕЇріГрЅх
Рю│№ИЈ	рЅБрѕѕ рѕхрѕЮріЋрЅх рЅ░ріЊрїІрѕф рі«ріерЅЦ рѕЮрѕЇріГрЅх
Рю│	рЅБрѕѕ рѕхрѕЮріЋрЅх рЅ░ріЊрїІрѕф рі«ріерЅЦ рѕЮрѕЇріГрЅх
Рю┤№ИЈ	рЅБрѕѕ рѕхрѕЮріЋрЅх рїФрЇЇ рі«ріерЅЦ
Рю┤	рЅБрѕѕ рѕхрѕЮріЋрЅх рїФрЇЇ рі«ріерЅЦ
РЮЄ№ИЈ	рЅЦрѕЇрїГрѕЇрїГ
РЮЄ	рЅЦрѕЇрїГрѕЇрїГ
Рђ╝№ИЈ	рІхрѕГрЅЦ ріарїІріќ рѕЮрѕЇріГрЅх
Рђ╝	рІхрѕГрЅЦ ріарїІріќ рѕЮрѕЇріГрЅх
РЂЅ№ИЈ	рЅЃрѕѕ ріарїІріќ рІерїЦрІФрЅё рѕЮрѕЇріГрЅх
РЂЅ	рЅЃрѕѕ ріарїІріќ рІерїЦрІФрЅё рѕЮрѕЇріГрЅх
РЮЊ	рІерїЦрІФрЅё рѕЮрѕЇріГрЅх
РЮћ	ріљрїГ рІерїЦрІФрЅё рѕЮрѕЇріГрЅх
РЮЋ	ріљрїГ рІерЅЃрѕѕ ріарїІріќ рѕЮрѕЇріГрЅх
РЮЌ	ріарїІріќ рѕЮрѕЇріГрЅх
сђ░№ИЈ	рѕърїѕрІх рѕ░рѕерІЮ
сђ░	рѕърїѕрІх рѕ░рѕерІЮ
┬Е№ИЈ	рІерЅЁрїѓ рѕўрЅЦрЅх
┬Е	рІерЅЁрїѓ рѕўрЅЦрЅх
┬«№ИЈ	рЅ░рѕўрІЮрїЇрЅДрѕЇ
┬«	рЅ░рѕўрІЮрїЇрЅДрѕЇ
Рёб№ИЈ	рІеріЋрїЇрІх рѕЮрѕЇріГрЅх
Рёб	рІеріЋрїЇрІх рѕЮрѕЇріГрЅх
#№ИЈРЃБ	рЅЂрѕЇрЇЇрЇА #
#РЃБ	рЅЂрѕЇрЇЇрЇА #
*№ИЈРЃБ	рЅЂрѕЇрЇЇ: *
*РЃБ	рЅЂрѕЇрЇЇ: *
0№ИЈРЃБ	рЅЂрѕЇрЇЇ: 0
0РЃБ	рЅЂрѕЇрЇЇ: 0
1№ИЈРЃБ	рЅЂрѕЇрЇЇ: 1
1РЃБ	рЅЂрѕЇрЇЇ: 1
2№ИЈРЃБ	рЅЂрѕЇрЇЇ: 2
2РЃБ	рЅЂрѕЇрЇЇ: 2
3№ИЈРЃБ	рЅЂрѕЇрЇЇрЇА 3
3РЃБ	рЅЂрѕЇрЇЇрЇА 3
4№ИЈРЃБ	рЅЂрѕЇрЇЇ: 4
4РЃБ	рЅЂрѕЇрЇЇ: 4
5№ИЈРЃБ	рЅЂрѕЇрЇЇ: 5
5РЃБ	рЅЂрѕЇрЇЇ: 5
6№ИЈРЃБ	рЅЂрѕЇрЇЇ: 6
6РЃБ	рЅЂрѕЇрЇЇ: 6
7№ИЈРЃБ	рЅЂрѕЇрЇЇ: 7
7РЃБ	рЅЂрѕЇрЇЇ: 7
8№ИЈРЃБ	рЅЂрѕЇрЇЇрЇА 8
8РЃБ	рЅЂрѕЇрЇЇрЇА 8
9№ИЈРЃБ	рЅЂрѕЇрЇЇрЇА 9
9РЃБ	рЅЂрѕЇрЇЇрЇА 9
­ЪћЪ	рЅЂрѕЇрЇЇ: 10
­Ъњ»	рѕўрЅХ ріљрїЦрЅЦ
­Ъћа	рїЇрЅцрЅх рѕІрЅ▓ріЋ ріарЅбрІГ рѕєрѕё
­ЪћА	рїЇрЅцрЅх рѕІрЅ▓ріЋ ріЋрІЉрѕх рѕєрѕё
­Ъћб	рІерїЇрЅцрЅх рЅЂрїЦрѕ«рЅй
­ЪћБ	рІерїЇрЅцрЅх рѕЮрѕЇріГрЅХрЅй
­Ъћц	рІерѕІрЅ▓ріЋ рЇірІ░рѕІрЅхріЋ ріарѕхрїѕрЅБ
­ЪЁ░№ИЈ	ріарІЮрѕФрѕГ (рІерІ░рѕЮ рІЊрІГріљрЅх)
­ЪЁ░	ріарІЮрѕФрѕГ (рІерІ░рѕЮ рІЊрІГріљрЅх)
­Ъєј	AB ріарІЮрѕФрѕГ (рІерІ░рѕЮ рІЊрІГріљрЅх)
­ЪЁ▒№ИЈ	B ріарІЮрѕФрѕГ (рІерІ░рѕЮ рІЊрІГріљрЅх)
­ЪЁ▒	B ріарІЮрѕФрѕГ (рІерІ░рѕЮ рІЊрІГріљрЅх)
­ЪєЉ	CL ріарІЮрѕФрѕГ
­Ъєњ	ріарѕфрЇЇ ріарІЮрѕФрѕГ
­ЪєЊ	ріљрЇЃ ріарІЮрѕФрѕГ
Рё╣№ИЈ	рѕўрѕерїЃ
Рё╣	рѕўрѕерїЃ
­Ъєћ	рІерѕўрЅ│рІѕрЅѓрІФ рЅЂрѕЇрЇЇ
РЊѓ№ИЈ	ріГрЅЦ M
РЊѓ	ріГрЅЦ M
­ЪєЋ	ріарІ▓рѕх ріарІЮрѕФрѕГ
­Ъєќ	NG ріарІЮрѕФрѕГ
­ЪЁЙ№ИЈ	рід ріарІЮрѕФрѕГ (рІерІ░рѕЮ рІЊрІГріљрЅх)
­ЪЁЙ	рід ріарІЮрѕФрѕГ (рІерІ░рѕЮ рІЊрІГріљрЅх)
­ЪєЌ	ріЦрѕ║ ріарІЮрѕФрѕГ
­ЪЁ┐№ИЈ	рЇњ ріарІЮрѕФрѕГ
­ЪЁ┐	рЇњ ріарІЮрѕФрѕГ
­Ъєў	рІеріцрѕхрідріцрѕх рЅЂрѕЇрЇЇ
­ЪєЎ	рІѕрІ░рѕІрІГ ріарІЮрѕФрѕГ
­Ъєџ	рЅфріцрѕх рЅЂрѕЇрЇЇ
­ЪѕЂ	рІерїЃрЇЊріЋ "ріЦрІџрѕЁ" ріарІЮрѕФрѕГ
­Ъѕѓ№ИЈ	рІерїЃрЇЊріЋ "рІеріарїѕрѕЇрїЇрѕјрЅх ріГрЇЇрІФ" ріарІЮрѕФрѕГ
­Ъѕѓ	рІерїЃрЇЊріЋ "рІеріарїѕрѕЇрїЇрѕјрЅх ріГрЇЇрІФ" ріарІЮрѕФрѕГ
­Ъѕи№ИЈ	рІерїЃрЇЊріЋ "рІѕрѕГрѕЃрІі рѕўрїаріЋ" ріарІЮрѕФрѕГ
­Ъѕи	рІерїЃрЇЊріЋ "рІѕрѕГрѕЃрІі рѕўрїаріЋ" ріарІЮрѕФрѕГ
­ЪѕХ	рІерїЃрЇЊріЋ "ріеріГрЇЇрІФ ріљрї╗ ріарІГрІ░рѕѕрѕЮ" ріарІЮрѕФрѕГ
­Ъѕ»	рІерїЃрЇЊріЋ "рІерЅ░рІФрІў" ріарІЮрѕФрѕГ
­ЪЅљ	рІерїЃрЇЊріЋ "рІхрѕГрІхрѕГ" ріарІЮрѕФрѕГ
­Ъѕ╣	рІерїЃрЇЊріЋ "рЅЁріЊрѕй" ріарІЮрѕФрѕГ
­Ъѕџ	рІерїЃрЇЊріЋ "ріеріГрЇЇрІФ ріљрї╗" ріарІЮрѕФрѕГ
­Ъѕ▓	рІерїЃрЇЊріЋ "рІерЅ░ріерѕѕріерѕѕ" ріарІЮрѕФрѕГ
­ЪЅЉ	рІерїЃрЇЊріЋ "рЅ░рЅђрЅБрІГріљрЅх рІФрѕѕрІЇ" ріарІЮрѕФрѕГ
­ЪѕИ	рІерїЃрЇЊріЋ "рѕўрЅ░рїЇрЅарѕфрІФ" ріарІЮрѕФрѕГ
­Ъѕ┤	рІерїЃрЇЊріЋ "рѕЏрѕѕрЇірІФ рІ░рѕерїЃ" рЅЂрѕЇрЇЇ
­Ъѕ│	рІерїЃрЇЊріЋ РђюріГрЇЇрЅх рЅдрЅ│РђЮ рЅЂрѕЇрЇЇ
сіЌ№ИЈ	рІерїЃрЇЊріЋ "ріЦріЋрі│ріЋ рІ░рѕх ріарѕѕрІјрЅх" ріарІЮрѕФрѕГ
сіЌ	рІерїЃрЇЊріЋ "ріЦріЋрі│ріЋ рІ░рѕх ріарѕѕрІјрЅх" ріарІЮрѕФрѕГ
сіЎ№ИЈ	рІерїЃрЇЊріЋ "рѕџрѕхрїЦрѕФрІі" ріарІЮрѕФрѕГ
сіЎ	рІерїЃрЇЊріЋ "рѕџрѕхрїЦрѕФрІі" ріарІЮрѕФрѕГ
­Ъѕ║	рІерїЃрЇЊріЋ "рѕѕріЋрїЇрІх ріГрЇЇрЅх" ріарІЮрѕФрѕГ
­Ъѕх	рІерїЃрЇЊріЋ "ріГрЇЇрЅх рЅдрЅ│ рІерѕѕрѕЮ" ріарІЮрѕФрѕГ
Рќф№ИЈ	рїЦрЅЂрѕГ рЅхріЋрѕй ріФрѕг
Рќф	рїЦрЅЂрѕГ рЅхріЋрѕй ріФрѕг
РќФ№ИЈ	ріљрїГ рЅхріЋрѕй ріФрѕг
РќФ	ріљрїГ рЅхріЋрѕй ріФрѕг
РЌ╗№ИЈ	ріљрїГ рѕўріФріерѕѕріЏ ріФрѕг
РЌ╗	ріљрїГ рѕўріФріерѕѕріЏ ріФрѕг
РЌ╝№ИЈ	рїЦрЅЂрѕГ рѕўріФріерѕѕріЏ ріФрѕг
РЌ╝	рїЦрЅЂрѕГ рѕўріФріерѕѕріЏ ріФрѕг
РЌй	ріљрїГ рѕўріФріерѕѕріЏ-рЅхріЋрѕй ріФрѕг
РЌЙ	рїЦрЅЂрѕГ рѕўріФріерѕѕріЏ-рЅхріЋрѕй ріФрѕг
РгЏ	рїЦрЅЂрѕГ рЅхрѕЇрЅЁ ріФрѕг
Ргю	ріљрїГ рЅхрѕЇрЅЁ ріФрѕг
­ЪћХ	рЅхрѕЇрЅЁ рЅЦрѕГрЅ▒ріФріЋрѕЏ ріарѕЇрѕЏрІЮ
­Ъћи	рЅхрѕЇрЅЁ рѕ░рѕЏрІФрІі ріарѕЇрѕЏрІЮ
­ЪћИ	рЅхріЋрѕй рЅЦрѕГрЅ▒ріФріЋрѕЏ ріарѕЇрѕЏрІЮ
­Ъћ╣	рЅхріЋрѕй рѕ░рѕЏрІФрІі ріарѕЇрѕЏрІЮ
­Ъћ║	рЅђрІГ рЅхрѕфрІФріЋрїЇрѕЇ рІѕрІ░ рѕІрІГ рїарЅЂрѕЪрѕЇ
­Ъћ╗	рЅђрІГ рЅхрѕфрІФріЋрїЇрѕЇ рІѕрІ░ рЅ│рЅй рЅ░рїарЅЂрѕЪрѕЇ
­Ъња	ріарѕЇрѕЏрІЮ ріеріљрїЦрЅЦ рїІрѕГ
­Ъћў	рІерѕгрІ▓рІ« ріарІЮрѕФрѕГ
­Ъћ▓	рїЦрЅЂрѕГ ріФрѕг ріарІЮрѕФрѕГ
­Ъћ│	ріљрїГ ріФрѕг ріарІЮрѕФрѕГ
Рџф	ріљрїГ ріГрЅЦ
РџФ	рїЦрЅЂрѕГ ріГрЅЦ
­Ъћ┤	рЅђрІГ ріГрЅЦ
­Ъћх	рѕ░рѕЏрІФрІі ріГрЅЦ
­ЪЈЂ	рѕЮрѕЇріГрЅх рІерЅ░рІ░рѕерїѕрЅарЅх рЅБріЋрІ▓рѕФ
­ЪџЕ	рЅБрѕѕрѕХрѕхрЅх рѕЏрІЋрІўріЋ рЅБріЋрІ▓рѕФ
­Ъјї	рІерЅ░рѕ╗рїѕрѕЕ рЅБріЋрІ▓рѕФрІјрЅй
­ЪЈ┤	рїЦрЅЂрѕГ рЅБріЋрІ▓рѕФ
­ЪЈ│№ИЈ	ріљрїГ рЅБріЋрІ▓рѕФ
­ЪЈ│	ріљрїГ рЅБріЋрІ▓рѕФ
­ЪЈ│№ИЈРђЇ­Ъїѕ	рЅђрѕхрЅ░ рІ░рѕўріЊ рЅБріЋрІ▓рѕФ
­ЪЈ│РђЇ­Ъїѕ	рЅђрѕхрЅ░ рІ░рѕўріЊ рЅБріЋрІ▓рѕФ
­ЪЈ┤РђЇРўа№ИЈ	рІерЅБрѕЁрѕГ рІѕріЋрЅарІ┤ рЅБріЋрІ▓рѕФ
­ЪЈ┤РђЇРўа	рІерЅБрѕЁрѕГ рІѕріЋрЅарІ┤ рЅБріЋрІ▓рѕФ
­ЪЄд­ЪЄе	ріарѕ┤ріЋрѕйріЋ рІ░рѕ┤рЅх
­ЪЄд­ЪЄЕ	ріаріЋрІХрѕФ
­ЪЄд­ЪЄф	рІЕріЊрІГрЅхрІх рІЊрѕерЅЦ ріцрѕЮрѕгрЅх
­ЪЄд­ЪЄФ	ріарЇЇрїІріњрѕхрЅ│ріЋ
­ЪЄд­ЪЄг	ріаріЋрЅ▓рїЊ ріЦріЊ рЅБрѕГрЅАрІ│
­ЪЄд­ЪЄ«	ріаріЋрїЅрѕІ
­ЪЄд­ЪЄ▒	ріарѕЇрЅБріњрІФ
­ЪЄд­ЪЄ▓	ріарѕГрѕюріњрІФ
­ЪЄд­ЪЄ┤	ріаріЋрїјрѕІ
­ЪЄд­ЪЄХ	ріаріЋрЅ│рѕГріГрЅ▓ріФ
­ЪЄд­ЪЄи	ріарѕГрїђріЋрЅ▓ріЊ
­ЪЄд­ЪЄИ	рІеріарѕюрѕфріФ рѕ│рѕъріа
­ЪЄд­ЪЄ╣	рідрѕхрЅхрѕФ
­ЪЄд­ЪЄ║	ріарІЇрѕхрЅхрѕФрѕірІФ
­ЪЄд­ЪЄ╝	ріарѕЕрЅБ
­ЪЄд­ЪЄй	рІеріарѕІріЋрІх рІ░рѕ┤рЅХрЅй
­ЪЄд­ЪЄ┐	ріарІўрѕГрЅБрїЃріЋ
­ЪЄД­ЪЄд	рЅдрѕхріњрІФ ріЦріЊ рѕёрѕГрІърїјрЅфріЊ
­ЪЄД­ЪЄД	рЅБрѕГрЅБрІХрѕх
­ЪЄД­ЪЄЕ	рЅБріЋрїЇрѕІрІхрѕй
­ЪЄД­ЪЄф	рЅцрѕЇрїёрѕЮ
­ЪЄД­ЪЄФ	рЅАрѕГріГріЊрЇІрѕХ
­ЪЄД­ЪЄг	рЅАрѕЇрїІрѕфрІФ
­ЪЄД­ЪЄГ	рЅБрѕЃрѕгріЋ
­ЪЄД­ЪЄ«	рЅАрѕЕріЋрІ▓
­ЪЄД­ЪЄ»	рЅцріњріњ
­ЪЄД­ЪЄ▒	рЅЁрІхрѕхрЅх рЅарѕГрЅ░рѕїрѕџ
­ЪЄД­ЪЄ▓	рЅцрѕГрѕЎрІ│
­ЪЄД­ЪЄ│	рЅЦрѕЕріћрІГ
­ЪЄД­ЪЄ┤	рЅдрѕірЅфрІФ
­ЪЄД­ЪЄХ	рІеріФрѕфрЅбрІФріЋ ріћрІўрѕГрѕІріЋрІхрѕх
­ЪЄД­ЪЄи	рЅЦрѕФрІџрѕЇ
­ЪЄД­ЪЄИ	рЅБрѕљрѕЏрѕх
­ЪЄД­ЪЄ╣	рЅарѕЊрЅ▒ріЋ
­ЪЄД­ЪЄ╗	рЅАрЅгрЅх рІ░рѕ┤рЅх
­ЪЄД­ЪЄ╝	рЅдрЅхрѕхрІІріЊ
­ЪЄД­ЪЄЙ	рЅцрѕІрѕЕрѕх
­ЪЄД­ЪЄ┐	рЅцрѕірІю
­ЪЄе­ЪЄд	ріФріЊрІ│
­ЪЄе­ЪЄе	рі«рі«рѕх (рігрѕіріЋрїЇ) рІ░рѕ┤рЅХрЅй
­ЪЄе­ЪЄЕ	рі«ріЋрїј - ріфріЋрѕ╗рѕ│
­ЪЄе­ЪЄФ	рѕ┤ріЋрЅхрѕФрѕЇ ріарЇЇрѕфріФ рѕфрЇЉрЅбрѕіріГ
­ЪЄе­ЪЄг	рі«ріЋрїј - рЅЦрѕФрІЏрЅфрѕЇ
­ЪЄе­ЪЄГ	рѕхрІірІўрѕфрѕІріЋрІх
­ЪЄе­ЪЄ«	рі«рЅхрІ▓рЅФрѕГ
­ЪЄе­ЪЄ░	ріЕріГ ріарІГрѕхрѕІріЋрІхрѕх
­ЪЄе­ЪЄ▒	рЅ║рѕі
­ЪЄе­ЪЄ▓	ріФрѕюрѕЕріЋ
­ЪЄе­ЪЄ│	рЅ╗рІГріЊ
­ЪЄе­ЪЄ┤	рі«рѕјрѕЮрЅбрІФ
­ЪЄе­ЪЄх	ріГрѕірЇЋрЅХріЋ рІ░рѕ┤рЅх
­ЪЄе­ЪЄи	рі«рѕхрЅ│рѕфріФ
­ЪЄе­ЪЄ║	ріЕрЅБ
­ЪЄе­ЪЄ╗	рігрЇЋ рЅгрѕфрІ┤
­ЪЄе­ЪЄ╝	ріЕрѕФріФрІј
­ЪЄе­ЪЄй	рІерїѕріЊ рІ░рѕ┤рЅх
­ЪЄе­ЪЄЙ	рЅєрїхрѕ«рѕх
­ЪЄе­ЪЄ┐	рЅ╝ріГрІФ
­ЪЄЕ­ЪЄф	рїђрѕГрѕўріЋ
­ЪЄЕ­ЪЄг	рІ▓рІгрїј рїІрѕГрѕ▓рІФ
­ЪЄЕ­ЪЄ»	рїЁрЅАрЅ▓
­ЪЄЕ­ЪЄ░	рІ┤ріЋрѕЏрѕфріГ
­ЪЄЕ­ЪЄ▓	рІХрѕџріњріФ
­ЪЄЕ­ЪЄ┤	рІХрѕџріњріФріЋ рѕфрЇЉрЅЦрѕіріГ
­ЪЄЕ­ЪЄ┐	ріарѕЇрїёрѕфрІФ
­ЪЄф­ЪЄд	рѕ┤ріАрЅ│ ріЦріЊ рѕюрѕірѕІ
­ЪЄф­ЪЄе	рібрі│рІХрѕГ
­ЪЄф­ЪЄф	рібрѕхрЅХріњрІФ
­ЪЄф­ЪЄг	рїЇрЅЦрїй
­ЪЄф­ЪЄГ	рѕЮрІЋрѕФрЅБрІі рѕ│рѕЃрѕФ
­ЪЄф­ЪЄи	ріцрѕГрЅхрѕфрІФ
­ЪЄф­ЪЄИ	рѕхрЇћріЋ
­ЪЄф­ЪЄ╣	рібрЅхрІ«рїхрІФ
­ЪЄф­ЪЄ║	рІеріарІЇрѕ«рЇЊ рѕЁрЅЦрѕерЅх
­ЪЄФ­ЪЄ«	рЇіріњрѕІріЋрІх
­ЪЄФ­ЪЄ»	рЇірїѓ
­ЪЄФ­ЪЄ░	рІерЇјріГрѕІріЋрІх рІ░рѕ┤рЅХрЅй
­ЪЄФ­ЪЄ▓	рѕџріГрѕ«ріћрІЦрІФ
­ЪЄФ­ЪЄ┤	рІерЇІрѕ« рІ░рѕ┤рЅХрЅй
­ЪЄФ­ЪЄи	рЇѕрѕеріЋрѕ│рІГ
­ЪЄг­ЪЄд	рїІрЅдріЋ
­ЪЄг­ЪЄД	рІерЅ░рЅБрЅарѕЕрЅх рІеріЋрїЅрѕЦ рїЇрІЏрЅх
­ЪЄг­ЪЄЕ	рїЇрѕфріЋрІ│рІ│
­ЪЄг­ЪЄф	рїєрѕГрїѓрІФ
­ЪЄг­ЪЄФ	рІерЇѕрѕеріЋрѕ│рІГ рїЅрІФріЊ
­ЪЄг­ЪЄг	рїѕрѕГріЋрѕ┤рІГ
­ЪЄг­ЪЄГ	рїІріЊ
­ЪЄг­ЪЄ«	рїірЅЦрѕФрѕЇрЅ│рѕГ
­ЪЄг­ЪЄ▒	рїЇрѕфріЋрѕІріЋрІх
­ЪЄг­ЪЄ▓	рїІрѕЮрЅбрІФ
­ЪЄг­ЪЄ│	рїіріњ
­ЪЄг­ЪЄх	рїЊрІ┤рѕјрЇЋ
­ЪЄг­ЪЄХ	рібрі│рЅХрѕфрІФрѕЇ рїіріњ
­ЪЄг­ЪЄи	рїЇрѕфріГ
­ЪЄг­ЪЄИ	рІ░рЅАрЅЦ рїєрѕГрїѓрІФ ріЦріЊ рІ░рЅАрЅЦ рѕ│ріЋрІхрІірЅй рІ░рѕ┤рЅХрЅй
­ЪЄг­ЪЄ╣	рїЊрЅ┤рѕЏрѕІ
­ЪЄг­ЪЄ║	рїЅріарѕю
­ЪЄг­ЪЄ╝	рїіріњ-рЅбрѕ│рІЇ
­ЪЄг­ЪЄЙ	рїЅрІФріЊ
­ЪЄГ­ЪЄ░	рѕєріЋрїЇ рі«ріЋрїЇ SAR рЅ╗рІГріЊ
­ЪЄГ­ЪЄ▓	рІерЅ░рѕ░рѕЏ ріЦріЊ рІерѕЏріГрІХріЊрѕЇрІх рІ░рѕ┤рЅХрЅй
­ЪЄГ­ЪЄ│	рѕєріЋрІ▒рѕФрѕх
­ЪЄГ­ЪЄи	ріГрѕ«рѕйрІФ
­ЪЄГ­ЪЄ╣	рѕЊрІГрЅ▓
­ЪЄГ­ЪЄ║	рѕЃріЋрїІрѕф
­ЪЄ«­ЪЄе	рІеріФріЊрѕф рІ░рѕ┤рЅХрЅй
­ЪЄ«­ЪЄЕ	рібріЋрІХріћрІЦрІФ
­ЪЄ«­ЪЄф	ріарІГрѕГрѕІрІх
­ЪЄ«­ЪЄ▒	ріЦрѕхрѕФріцрѕЇ
­ЪЄ«­ЪЄ▓	рІерѕ░рІЇ рІ░рѕ┤рЅх
­ЪЄ«­ЪЄ│	рѕЋріЋрІх
­ЪЄ«­ЪЄ┤	рІерЅЦрѕфрЅ▓рѕй рѕЁріЋрІх рІЇрЅЁрІФріќрѕх рїЇрІЏрЅх
­ЪЄ«­ЪЄХ	рібрѕФрЅЁ
­ЪЄ«­ЪЄи	рібрѕФріЋ
­ЪЄ«­ЪЄИ	ріарІГрѕхрѕІріЋрІх
­ЪЄ«­ЪЄ╣	рїБрѕірІФріЋ
­ЪЄ»­ЪЄф	рїђрѕГрѕ▓
­ЪЄ»­ЪЄ▓	рїЃрѕЏрІГріФ
­ЪЄ»­ЪЄ┤	рІ«рѕГрІ│ріќрѕх
­ЪЄ»­ЪЄх	рїЃрЇЊріЋ
­ЪЄ░­ЪЄф	рігріЋрІФ
­ЪЄ░­ЪЄг	ріГрІГрѕГрїІрІЮрѕхрЅ│ріЋ
­ЪЄ░­ЪЄГ	ріФрѕЮрЅдрІ▓рІФ
­ЪЄ░­ЪЄ«	ріфрѕфрЅБрЅ▓
­ЪЄ░­ЪЄ▓	рі«рѕърѕ«рѕх
­ЪЄ░­ЪЄ│	рѕ┤ріЋрЅх ріфрЅхрѕх ріЦріЊ ріћрЅфрѕх
­ЪЄ░­ЪЄх	рѕ░рѕюріЊрІі рі«рѕфрІФ
­ЪЄ░­ЪЄи	рІ░рЅАрЅЦ рі«рѕфрІФ
­ЪЄ░­ЪЄ╝	ріхрІїрЅх
­ЪЄ░­ЪЄЙ	рігрІГрѕЏріЋ ріарІГрѕхрѕІріЋрІх
­ЪЄ░­ЪЄ┐	ріФрІЏріГрѕхрЅ│ріЋ
­ЪЄ▒­ЪЄд	рѕІрідрѕх
­ЪЄ▒­ЪЄД	рѕірЅБріќрѕх
­ЪЄ▒­ЪЄе	рЅЁрІхрѕхрЅх рѕЅрЅ║рІФ
­ЪЄ▒­ЪЄ«	рѕѕрІГрЅйрЅ┤ріЋрѕхрЅ┤рІГріЋ
­ЪЄ▒­ЪЄ░	рѕ▓рѕфрѕІріЋріФ
­ЪЄ▒­ЪЄи	рѕІрІГрЅцрѕфрІФ
­ЪЄ▒­ЪЄИ	рѕїрѕхрЅХ
­ЪЄ▒­ЪЄ╣	рѕірЅ▒ріаріњрІФ
­ЪЄ▒­ЪЄ║	рѕЅрІўрѕЮрЅцрѕГрїЇ
­ЪЄ▒­ЪЄ╗	рѕІрЅ▓рЅфрІФ
­ЪЄ▒­ЪЄЙ	рѕірЅбрІФ
­ЪЄ▓­ЪЄд	рѕърѕ«рі«
­ЪЄ▓­ЪЄе	рѕъріЊрі«
­ЪЄ▓­ЪЄЕ	рѕърѕЇрІХрЅФ
­ЪЄ▓­ЪЄф	рѕъріЋрЅ┤ріћрїЇрѕ«
­ЪЄ▓­ЪЄФ	рЅЁрІ▒рѕх рѕЏрѕГрЅ▓ріЋ
­ЪЄ▓­ЪЄг	рѕЏрІ│рїІрѕхріФрѕГ
­ЪЄ▓­ЪЄГ	рѕЏрѕГрѕ╗рѕЇ ріарІГрѕхрѕІріЋрІх
­ЪЄ▓­ЪЄ░	рѕўрЅёрІХріњрІФ
­ЪЄ▓­ЪЄ▒	рѕЏрѕі
­ЪЄ▓­ЪЄ▓	рѕЮрІФріЋрѕЏрѕГ (рЅарѕГрѕЏ)
­ЪЄ▓­ЪЄ│	рѕъріЋрїјрѕірІФ
­ЪЄ▓­ЪЄ┤	рѕЏріФрІј SAR рЅ╗рІГріЊ
­ЪЄ▓­ЪЄх	рІерѕ░рѕюріЊрІі рѕЏрѕфрІФріЊ ріарІГрѕхрѕІріЋрІхрѕх
­ЪЄ▓­ЪЄХ	рѕЏрѕГрЅ▓ріњріГ
­ЪЄ▓­ЪЄи	рѕърѕфрЅ│ріњрІФ
­ЪЄ▓­ЪЄИ	рѕъріЋрЅхрѕ┤рѕФрЅх
­ЪЄ▓­ЪЄ╣	рѕЏрѕЇрЅ│
­ЪЄ▓­ЪЄ║	рѕърѕфрѕ╝рѕх
­ЪЄ▓­ЪЄ╗	рѕЏрѕЇрІ▓рЅгрѕх
­ЪЄ▓­ЪЄ╝	рѕЏрѕІрІі
­ЪЄ▓­ЪЄй	рѕюріГрѕхрі«
­ЪЄ▓­ЪЄЙ	рѕЏрѕїрІЦрІФ
­ЪЄ▓­ЪЄ┐	рѕърІЏрѕЮрЅбріГ
­ЪЄ│­ЪЄд	ріЊрѕЮрЅбрІФ
­ЪЄ│­ЪЄе	ріњрІЇ ріФрѕїрІХріњрІФ
­ЪЄ│­ЪЄф	ріњрїђрѕГ
­ЪЄ│­ЪЄФ	ріќрѕГрЇјрѕЇріГ ріарІГрѕхрѕІріЋрІхрѕх
­ЪЄ│­ЪЄг	ріЊрІГрїёрѕфрІФ
­ЪЄ│­ЪЄ«	ріњріФрѕФрїЅріа
­ЪЄ│­ЪЄ▒	ріћрІюрѕфрѕІріЋрІх
­ЪЄ│­ЪЄ┤	ріќрѕГрІїрІГ
­ЪЄ│­ЪЄх	ріћрЇЊрѕЇ
­ЪЄ│­ЪЄи	ріЊріАрѕЕ
­ЪЄ│­ЪЄ║	ріњрІГріА
­ЪЄ│­ЪЄ┐	ріњрІЇрІџрѕІріЋрІх
­ЪЄ┤­ЪЄ▓	рідрѕЏріЋ
­ЪЄх­ЪЄд	рЇЊріЊрѕЏ
­ЪЄх­ЪЄф	рЇћрѕЕ
­ЪЄх­ЪЄФ	рІерЇѕрѕеріЋрѕ│рІГ рЇќрѕіріћрІЦрІФ
­ЪЄх­ЪЄг	рЇЊрЇЊрІФ ріњрІЇ рїіріњ
­ЪЄх­ЪЄГ	рЇірѕірЇЋріЋрѕ▓
­ЪЄх­ЪЄ░	рЇЊріфрѕхрЅ│ріЋ
­ЪЄх­ЪЄ▒	рЇќрѕІріЋрІх
­ЪЄх­ЪЄ▓	рѕ┤ріЋрЅх рЇњрІерѕГ & Miquelon
­ЪЄх­ЪЄ│	рЇњрЅхріФрІГрѕГріЋ ріарІГрѕхрѕІріЋрІхрѕх
­ЪЄх­ЪЄи	рЇЉріцрѕГрЅХ рѕфрі«
­ЪЄх­ЪЄИ	рІерЇЇрѕЇрѕхрїцрѕЮ рїЇрІЏрЅХрЅй
­ЪЄх­ЪЄ╣	рЇќрѕГрЅ╣рїІрѕЇ
­ЪЄх­ЪЄ╝	рЇЊрѕІріА
­ЪЄх­ЪЄЙ	рЇЊрѕФрїЊрІГ
­ЪЄХ­ЪЄд	рі│рЅ│рѕГ
­ЪЄи­ЪЄф	рѕфрІЕріЋрІ«ріЋ
­ЪЄи­ЪЄ┤	рѕ«рѕЏріњрІФ
­ЪЄи­ЪЄИ	рѕ┤рѕГрЅбрІФ
­ЪЄи­ЪЄ║	рѕФрѕйрІФ
­ЪЄи­ЪЄ╝	рѕЕрІІріЋрІ│
­ЪЄИ­ЪЄд	рѕ│рІЇрІ▓ рІЊрѕерЅбрІФ
­ЪЄИ­ЪЄД	рІерѕ░рѕјрѕъріЋ ріарІГрѕхрѕІріЋрІхрѕх
­ЪЄИ­ЪЄе	рѕ▓рѕ╝рѕЇрѕх
­ЪЄИ­ЪЄЕ	рѕ▒рІ│ріЋ
­ЪЄИ­ЪЄф	рѕхрІірІ▓ріЋ
­ЪЄИ­ЪЄг	рѕхріЋрїІрЇќрѕГ
­ЪЄИ­ЪЄГ	рЅЁрІхрѕхрЅх рѕёрѕѕріЊ
­ЪЄИ­ЪЄ«	рѕхрѕјрЅФріњрІФ
­ЪЄИ­ЪЄ»	рѕхрЅФрѕЇрЅБрѕГрІх ріЦріЊ рїЃріЋ рѕЏрІеріЋ
­ЪЄИ­ЪЄ░	рѕхрѕјрЅФріњріФ
­ЪЄИ­ЪЄ▒	рѕ░рѕФрѕірІ«ріЋ
­ЪЄИ­ЪЄ▓	рѕ│ріЋ рѕЏрѕфріќ
­ЪЄИ­ЪЄ│	рѕ┤ріћрїІрѕЇ
­ЪЄИ­ЪЄ┤	рѕХрѕЏрѕірІФ
­ЪЄИ­ЪЄи	рѕ▒рѕфріЊрѕю
­ЪЄИ­ЪЄИ	рІ░рЅАрЅЦ рѕ▒рІ│ріЋ
­ЪЄИ­ЪЄ╣	рѕ│рід рЅХрѕю ріЦріЊ рЇЋрѕфріЋрѕ▓рЇћ
­ЪЄИ­ЪЄ╗	ріцрѕЇрѕ│рѕЇрЅФрІХрѕГ
­ЪЄИ­ЪЄй	рѕ▓ріЋрЅх рѕЏрѕГрЅ░ріЋ
­ЪЄИ­ЪЄЙ	рѕХрѕфрІФ
­ЪЄИ­ЪЄ┐	рѕхрІІрІЮрѕІрІх
­ЪЄ╣­ЪЄд	рЅхрѕфрѕхрЅ│ріЋ рІ│ ріЕріЋрѕЃ
­ЪЄ╣­ЪЄе	рЅ▒рѕГрі«рЅй ріЦріЊ рІеріФрІГрі«рѕх рІ░рѕ┤рЅХрЅй
­ЪЄ╣­ЪЄЕ	рЅ╗рІх
­ЪЄ╣­ЪЄФ	рІерЇѕрѕеріЋрѕ│рІГ рІ░рЅАрЅБрІі рїЇрІЏрЅХрЅй
­ЪЄ╣­ЪЄг	рЅХрїј
­ЪЄ╣­ЪЄГ	рЅ│рІГрѕІріЋрІх
­ЪЄ╣­ЪЄ»	рЅ│рїѓріфрѕхрЅ│ріЋ
­ЪЄ╣­ЪЄ░	рЅХрігрѕІріА
­ЪЄ╣­ЪЄ▒	рЅ▓рѕърѕГ-рѕїрѕхрЅ┤
­ЪЄ╣­ЪЄ▓	рЅ▒рѕГріГрѕюріњрѕхрЅ│ріЋ
­ЪЄ╣­ЪЄ│	рЅ▒ріЋрѕ▓рІФ
­ЪЄ╣­ЪЄ┤	рЅХріЋрїІ
­ЪЄ╣­ЪЄи	рЅ▒рѕфріГ
­ЪЄ╣­ЪЄ╣	рЅхрѕфріЋрІ│рІх ріЦріЊ рЅХрЅцрїј
­ЪЄ╣­ЪЄ╗	рЅ▒рЅФрѕЅ
­ЪЄ╣­ЪЄ╝	рЅ│рІГрІІріЋ
­ЪЄ╣­ЪЄ┐	рЅ│ріЋрІЏріЋріњрІФ
­ЪЄ║­ЪЄд	рІЕріГрѕгріЋ
­ЪЄ║­ЪЄг	ріАрїІріЋрІ│
­ЪЄ║­ЪЄ▓	рІерІЕріцрѕх рІЇрїфрІФрІі рІ░рѕ┤рЅХрЅй
­ЪЄ║­ЪЄ│	рІерЅ░рЅБрЅарѕЕрЅх рѕўріЋрїЇрѕхрЅ│рЅх
­ЪЄ║­ЪЄИ	рІЕріЊрІГрЅхрІх рѕхрЅ┤рЅ░рЅх
­ЪЄ║­ЪЄЙ	ріАрѕФрїІрІГ
­ЪЄ║­ЪЄ┐	ріАрІЮрЅцріГрѕхрЅ│ріЋ
­ЪЄ╗­ЪЄд	рІерЅФрЅ▓ріФріЋ ріерЅ░рѕЏ
­ЪЄ╗­ЪЄе	рѕ┤ріЋрЅх рЅфріЋрѕ░ріЋрЅх ріЦріЊ рїЇрѕгріЊрІ▓ріЋрѕх
­ЪЄ╗­ЪЄф	рЅеріЋрІЎрІІрѕІ
­ЪЄ╗­ЪЄг	рІерЅЦрѕфрЅ▓рѕй рЅерѕГрїѓріЋ рІ░рѕ┤рЅХрЅй
­ЪЄ╗­ЪЄ«	рІерІЕріцрѕх рЅерѕГрїѓріЋ рІ░рѕ┤рЅХрЅй
­ЪЄ╗­ЪЄ│	рЅфрЅхріЊрѕЮ
­ЪЄ╗­ЪЄ║	рЅФріЉріарЅ▒
­ЪЄ╝­ЪЄФ	рІІрѕірѕх ріЦріЊ рЇЅрЅ▒ріЊ
­ЪЄ╝­ЪЄИ	рѕ│рѕъріа
­ЪЄй­ЪЄ░	рі«рѕХрЅ«
­ЪЄЙ­ЪЄф	рІерѕўріЋ
­ЪЄЙ­ЪЄ╣	рѕЏрІ«рЅх
­ЪЄ┐­ЪЄд	рІ░рЅАрЅЦ ріарЇЇрѕфрЅЃ
­ЪЄ┐­ЪЄ▓	рІЏрѕЮрЅбрІФ
­ЪЄ┐­ЪЄ╝	рІЮрѕЮрЅБрЅАрІї
­ЪЈ┤заЂДзаЂбзаЂЦзаЂ«заЂДзаЂ┐	ріЦріЋрїЇрѕірІЮ
­ЪЈ┤заЂДзаЂбзаЂ│заЂБзаЂ┤заЂ┐	рѕхрі«рЅхрѕІріЋрІх
­ЪЈ┤заЂДзаЂбзаЂизаЂгзаЂ│заЂ┐	рІїрѕЇрѕх
